%%%%%%%%%%%%%%%%%%%%%%%%%%%%%%
%.      % % %              %.%
%       % % %%%%%% %%%%%%% % %
%       %        %     % %   %
%%%%% %%%%% %%% %% %%%%% % %%%
%   % % % % . %    %     %   %
% %%% % % % %%%%%%%% %%% %%% %
%       %  .  %%     % % %   %
%%% % %%%%%%% %%%% %%% % % % %
% %      .    %%     %     % %
% % %%%%% % %%%% % %%% %%% % %
%   %     %      % %   % %%% %
%.  %P%%%%% P    % %%% %    .%
%%%%%%%%%%%%%%%%%%%%%%%%%%%%%%
