%%%%%%%%%%%%%%%%%%%%%%%%%%%%%%%%%%%%%
%. .   .%.%.%      .    %   %     % %
% %%%%%%%.%.%%% %.%%% %%%.%%%%%%% % %
% .. ...%       % %   . %     % % ..%
%%%%% %%%%%.%%% % % % %%% %%%%% % %%%
% . % %.% % . %.% % %   % %.. %.%   %
% %%% % % %.%%% %%%%%.%%% % %%%.%%% %
%..  . .%  .  %   % . %   . %.% % . %
%%% %%%%%%%%%.%%%%%%%.%%% %%% %.% % %
%..     . .   %..   . % % ..% ..  %.%
% % %%%%% %.%%% % %.%%%.% %%% %%% % %
% % % .  .% % %.% %.    %.  %.% %.%.%
% % % %%%%%%%.% %%%%%%%%%.%%%.% %%% %
% %.% %     %   %.    %.    %   %.. %
%%%.%%% %.%%%%% %%%%% %%%.%%% %%%%% %
% .. .% % %.   .%.%    .% %   % %.% %
%.%.%.%.% %%%.%%% %%% %%%.% %.% % % %
% % %.% %   .      . .  . %.%.%...  %
%%% %%%%%%% %.% %%%%%.%%% % %%% %%%%%
%       %.% %.%  . .%   %. ...%.%   %
%%%%%.%.%.%%%%%%%%% %%%%%%%%%%% % %%%
%. .%.%  ...  .  .%.%  .  %   % %   %
% %%% %%%%% %%%%%%%%%.%%%%%.% % %%% %
% %.  %      %     . .% .  .%   .   %
% % % %%%%% %%%.% % % %.%%%%%%%%%%%%%
% % %  .%.    %.%.%.%   .   %   % % %
%.% %%% %%% % %.% %%%%%%%%%.%%% % %.%
%.%.  % % . % % %.  %.%.  % %.%..   %
%.%%% %%% %%%%% %%% % % %%%%% %.%%%%%
% ..   .%   %   . % %.    %.  %.%   %
%%% %.%%%%%.%%%%% %%% %%% % %%%.%.%%%
% % % % % % % %. .  % % ..% %.  % % %
%.% %%% % % % % %%%%%%%%%.% % % % % %
% ..% ..%   %..     . .   .  .%     %
% % % %.%%% %%%.%%%%%%% %%% %%% %%% %
%P%P%.%..    .%.  %. . .  %   % %PP %
%%%%%%%%%%%%%%%%%%%%%%%%%%%%%%%%%%%%%