%%%%%%%%%%%%%%%%%%%%%%%%%%%%%%%%%%%%%%
%                        .          P%
% %%%%%%%%%%%%%%%%%%% %%%  %%%%%%%%  %
% %%   %   % .    %%% %%%    %%      %
% %% % % % % %%%% %%%%%%%%%  %%  %%%%%
% %%.% % % % %    %%         %% .    %
% %%.% % % % %.%%%%%  %%% .  %%%%%%. %
% %% % %.%   %    %%  %%%%%%%%%  .   %
% %%.% % %%%%%%%% %%     .   %%  %%%%%
% %%.%   %%       %%%%%%%%%..%%      %
%.   %%% %% %%%%%%%      %%  %%%%%% .%
%%%%%%    . %       % .  %%  %%   .  %
% .    %%%%%% %% ..%%.   %%  %%  %%%%%
% %%%%%%    . %       %%%%%  %%      %
%        . %%%% .     %%%%%  %%%%%%  %
%%%%%%%%   %.              . %%%%%%  %
%.  .      %%%%%%%%%%%%%%%%      PPP %
%%%%%%%%%%%%%%%%%%%%%%%%%%%%%%%%%%%%%%
