%%%%%%%%%%%%%%%%%%%%%%%%%%%%%%%%%%%%%
%..     %          .      .     . %.%
% ..      %%%%% % %%% %%%.%%%%%%% % %
%       %       % %. .  %P   .% %.. %
%%%%% %%%%% %%%.% % %.%%%.%%%%% %.%%%
%   % % % %   % %.% %   % %     %   %
% %%% % % % %%% %%%%%.%%% % %%% %%% %
%  .   .%     %  .%.. %     %.%.%  .%
%%% %%%%%%%%% %%%%%%% %%% %%% % % % %
%  .          %     . %.%.  % .   % %
% % %%%%%.% %%% % %.%%% % %%%.%%% % %
% % %  .. % % % %.%   . % . % % % % %
% %.% %%%%%%%.% %%%%%%%%%.%%% % %%% %
%.%.%.%.    %. .%  .. % .   %   % ..%
%%%.%%% % %%%%% %%%%%.%%% %%% %%%%% %
%    .% %      . .      %.%   % % % %
% % % % %  %  %%% %%% %%% % % % % % %
% % % % % %%    % % . %   %.%.%     %
% % %%%%%  % .%%% %%%.% %%% %%% %%%%%
% ..   .%  % .  % %   %..   . % %   %
% %%% %.%..%  %%% %%% %%%%%%%%% % %%%
%. .% % .   .       . .   %   % %   %
% %%% %%%%%%%%%%%%%%%%%%%%% % % %%% %
% %       .    . .   . ..   %   .  .%
% % % %%%%%.%%% % %.% % %%%%%%%%%%%%%
% % % . %     %.% % %. .    % . % % %
% % %%%.%%% % % % %%%%%%%%% %%% %.% %
% %   %.%  .% % %P .% % . %.% %     %
% %%% %%% %%% % %%% % % %%%%% % %%%%%
%     . %  .% .   %  .    %   % %   %
%%% %.%%%%%.%%%%%.%%% %%% % %%% % %%%
%.% %.%.% % % %..   % %   % %.  % % %
%.% %%%.%.% % %.%%%%%%%%% % % % %P% %
%     . %.       . .  .  .    %   P %
%.%   % %%% %%% %%%%%%% %%% %%%.%%%.%
%.%  .%       %           %    .%  .%
%%%%%%%%%%%%%%%%%%%%%%%%%%%%%%%%%%%%%