%%%%%%%%%%%%%%%%%%%%%%%%%%%%%%%
% .   %. .            . %. . .%
% %%%.% %%% %%%%%%% %%%.%     %
%.%   % %      %      % % .   %
%   %%% % %%%% %.%%%%...%%% . %
%%% % % %.% ..   %  % %  .% %%%
%   % %%% % %%%.%%% %.%%%.%  .%
%.%%%       % .   %     . %%% %
%.  %.%%%%% %%%%%%% %P%%% %.  %
%%% %   %.%    % .  % %  .% %%%
% . %%%.% %%%%.% %%%% % %%%. .%
%   .   %   .  % . .  %     % %
%     % %%% %%%%%%% %%% % %%% %
%     %        P.   % . %.    %
%%%%%%%%%%%%%%%%%%%%%%%%%%%%%%%