%%%%%%%%%%%%%%%%%%%%%%%%%%%%
%     .     .%%      P.  . %
% %%%% %%%%% %% %%%%% %%%% %
%.%%%% %%%%%.%% %%%%% %%%%.%
% %%%% %%%%% %% %%%%% %%%% %
%        .  .         .    %
% %%%% %% %%%%%%%% %% %%%% %
% %%%% %% %%%%%%%% %% %%%% %
%     .%%    %%    %%      %
%%%%%% %%%%% %% %%%%% %%%%%%
%%%%%% %%%%% %% %%%%% %%%%%%
%%%%%% %.           % %%%%%%
%%%%%%.%.%%%%  %%%% % %%%%%%
%     .  %.      .%.       %
%%%%%% % %%%%%%%%%% % %%%%%%
%%%%%% %            % %%%%%%
%%%%%% % %%%%%%%%%% % %%%%%%
%           .%%            %
%.%%%% %%%%% %% %%%%% %%%% %
% %%%% %%%%% %% %%%%% %%%% %
%   %%.               %%   %
%%%.%% %% %%%%%%%% %% %% %%%
%%% %% %% %%%%%%%% %% %% %%%
%      %%  . %%   .%%      %
% %%%%%%%%%%.%% %%%%%%%%%%.%
% .P  .  .    P      P     %
%%%%%%%%%%%%%%%%%%%%%%%%%%%%