%%%%%%%%%%%%%%%%%%%%%%%%%%%%%%%%%%%%%
%.      %.   .     .      .   PPPP%.%
%.    .  .%%%%% % %%% %%% %%%%%%%.%.%
%  . .  %  .   .%.%     %.  . % %  .%
%%%%% %%%%% %%% %.% % %%% %%%%% % %%%
%.  % % %.% ..% % % %  .%.%    .%   %
%.%%% % % % %%% %%%%% %%% %.%%% %%%.%
%       %..  .%   % . %     % %.%.  %
%%% %%%%%%%%% %%%%%%% %%% %%%.% % % %
%  . ..     . % . . ..% %.  %     % %
%.% %%%%% %.%%% % % %%% % %%%.%%%.% %
%.% %     % % % %.%     %   % % % % %
% % %.%%%%%%% % %%%%%%%%% %%% % %%% %
%.% %.%  .  %   % .   %     %   %.. %
%%%.%%%.% %%%%% %%%%% %%%.%%% %%%%% %
%     %.%      .       .%.% ..% %.%.%
% % %.% %. %  %%% %%% %%% % % % %.%.%
% %.% %.%.%%  ..% %  .%   % % %     %
% % %%%%%  %  %%% %%% % %%% %%% %%%%%
%    .. %. %    % % . % .     %.%   %
% %%% % %. %  %%% %%% %%%%%%%%% % %%%
%   % %       . ..    ..  %.  % %   %
% %%% %%%%%%%%%%%%%%%%%%%%% % %.%%% %
%.% .    ..  ..             %       %
% % % %%%%% %%%.% % %.% %%%%%%%%%%%%%
% % %   %.    % % % %   .   %   % %.%
% % %%% %%% %.% % %%%%%%%%% %%% % % %
%.%   % % . % % %P. % %  .%.% %.    %
% %%% %%% %%% % %%% % % %%%%%.% %%%%%
%   .   %.  %     %. .    % . % %  .%
%%% % %%%%% %%%%% %%% %%% % %%% % %%%
% % % % %.% % %     % %   % %  .% % %
%.% %%% % % % % %%%%%%%%% % % % % % %
%   .   %.          .   .     % .   %
% %   % %%% %%% %%%%%%% %%% %%%.%%% %
%.%   %  . . .%       .   %  .  %  .%
%%%%%%%%%%%%%%%%%%%%%%%%%%%%%%%%%%%%%