%%%%%%%%%%%%%%%%%%%%%%%%%%%%%%%%%%%%%
%..   . %.      .          ...PPPP%.%
% . .    .%%%%% %.%%% %%% %%%%%%%.%.%
%. .  . %   .   % % ... %  . .% % . %
%%%%%.%%%%% %%% % % % %%% %%%%% %.%%%
%.  % % % % . % % % %  .% %..   %.  %
%.%%% %.% % %%%.%%%%% %%% % %%% %%% %
%  .    %    .% . % . %     %.% %.  %
%%% %%%%%%%%% %%%%%%%.%%%.%%%.% %.%.%
% .    . . . .%. .    % %   %.    % %
% % %%%%% % %%% % % %%% % %%% %%%.%.%
%.% %.... % % % % %   ..%  .% % % % %
% % % %%%%%%%.% %%%%%%%%% %%%.% %%% %
%.% % % .  .%   %     %. .  %  .% . %
%%% %%% % %%%%% %%%%% %%% %%%.%%%%%.%
%     % %       .     . % %. .% % % %
%.%.% % %. % .%%% %%% %%% % %.% % % %
% % % % % %%  . % %   %   % % % .   %
%.% %%%%% .%  %%% %%% %.%%% %%% %%%%%
%.    . %  %. ..%.%   %  .. ..% % . %
% %%%.%.%  %  %%% %%% %%%%%%%%% %.%%%
%  .% % .  .  .        . .%.. % % . %
% %%% %%%%%%%%%%%%%%%%%%%%%.%.% %%% %
% %...    ..     .      ... %.  . ..%
% % %.%%%%%.%%% % % % % %%%%%%%%%%%%%
%.% %   %    .% %.% %.  . . %   % % %
%.%.%%% %%% % %.% %%%%%%%%%.%%%.% %.%
% %   % %  .% % %P  % %. .%.% % .   %
% %%% %%% %%% %.%%% % %.%%%%%.% %%%%%
%  ..  .%  .% .   %      .%.  %.% . %
%%%.% %%%%% %%%%% %%%.%%% % %%% %.%%%
% %.% %.% % % %. .. % %  .%.%   %.%.%
% % %%%.%.% % %.%%%%%%%%% % % % %.% %
%     . %    . ... . . . .   .%.    %
% %.  %.%%%.%%% %%%%%%% %%% %%%.%%% %
%.%   % . .  .%. ...  ... %  .  %  .%
%%%%%%%%%%%%%%%%%%%%%%%%%%%%%%%%%%%%%