%%%%%%%%%%%%%%%%%%%%%%%%%%%%%%%
%.    %.       .     .  %.    %
% %%% %.%%% %%%%%%% %%% %  P. %
% %   % %   .  %    . % %    .%
%   %%% % %%%% % %%%%   %%%   %
%%% %.% % %    . %  % %   % %%%
%   % %%% % %%% %%% % %%% %   %
% %%%  .    %     %      .%%% %
%   %.%%%%% %%%%%%% % %%% % . %
%%% %  .% %    %    % %   % %%%
%   %%% % %%%% % %%%% % %%%   %
%.      %      %      %  .  % %
%     % %%% %%%%%%% %%% % %%% %
%    .%  .     P    % . %     %
%%%%%%%%%%%%%%%%%%%%%%%%%%%%%%%