%%%%%%%%%%%%%%%%%%%%%%%%%%%%%%%%%%%%%
%.      % %.%        .. % . %  .  %.%
% %%%%%%% % %%% %.%%% %%% %%%%%%% % %
%..  .  %    ...% %.   .%     % %  .%
%%%%%.%%%%% %%% % %.% %%% %%%%% % %%%
%   % % % %   % % % %   % %   %.%  .%
% %%% % % % %%% %%%%% %%% % %%% %%% %
%.      %     %   %   %   . %.% %   %
%%% %%%%%%%%% %%%%%%% %%% %%% % % %.%
%.     ..     %.     .% %.  %     % %
% % %%%%% %.%%%.% % %%% %.%%% %%% %.%
% % %    .% % %.% %     %   %.% % % %
% %.% %%%%%%%.%.%%%%%%%%% %%% %.%%% %
% % % %..   %   %  .  %  .  %   % . %
%%% %%% % %%%%%.%%%%% %%% %%% %%%%% %
%..   % % %     % %     %.%.  % % % %
% % % % %.%%% %%% %%%.%%% % % % % % %
% % % % %      .   .    . % % %     %
%%% %%%%%%% % % %%%%% %%%.% %%% %%%%%
% .  .  % % % %     %   %  ...% % . %
%%%%%.% % %%%%%%%%%.%%%%%%%%%%%.% %%%
%   % %  ..  ..   % %. .  %   %.%   %
%.%%% %%%%% %%%%%%%%% %%%%% %.% %%% %
% %   %   .  %        %     %     . %
% % % %%%%% %%% % %.% % %%%%%%%%%%%%%
% % %.  %     % % % %.   .  % ..% % %
%.% %%% %%% % % % %%%%%%%%%.%%% % %.%
%.% ..% %   % % %   % %   %.% %    .%
% %%% %%% %%%%% %%%.%.% %%%%% % %%%%%
%    .. % . % .   % %     % ..% %   %
%%% % %%%%% %%%%% %%% %%% %.%%% % %%%
% % % % %.% % %     % %. .%.%  .% % %
% % %%% %.%.% % %%%%%%%%%.% % % % % %
%  .% . %. .%   .      . .   .% .  .%
% % %.% %%%.%%% %%%%%%%.%%%.%%% %%%P%
%.% % %      .%   %.   ...%   % %PPP%
%%%%%%%%%%%%%%%%%%%%%%%%%%%%%%%%%%%%%