%%%%%%%%%%%%%%%%%%%%%%%%%%%%%%%%%%%%%
%. ..   %         .    ...    PPPP%.%
%    .  ..%%%%%.% %%% %%% %%%%%%% % %
%     . %      .% %     %     % %   %
%%%%% %%%%% %%% % % % %%% %%%%% %.%%%
%   % %.% %. .% % %.%   %.%  .  %   %
% %%%.% % % %%% %%%%% %%% % %%% %%% %
%     . %   . % . %   %    .% % %   %
%%%.%%%%%%%%%.%%%%%%% %%% %%% %.%.% %
%    .        %   . . % %.  %.  . % %
% %.%%%%% % %%% % % %%% % %%% %%% % %
% %.%  .  % %.% % %    .%   %.% %.% %
% % % %%%%%%% %.%%%%%%%%%.%%% % %%% %
%.% % % .  .%   % . . %..   %.  %  .%
%%% %%% % %%%%% %%%%%.%%% %%% %%%%% %
%    .% %       .       % %. .% % % %
% % % %.%..%  %%% %%%.%%% % % % % % %
% % % % % %% . .% %.  %   % % % .   %
%.% %%%%%. %  %%%.%%% %.%%% %%% %%%%%
%. .    % .%  ..% %  .%... .  % %   %
%.%%% % %  %  %%% %%% %%%%%%%%% % %%%
%  .% %  .    .   .  .   .%.  % %   %
% %%% %%%%%%%%%%%%%%%%%%%%% % % %%% %
% %..            .   . .    %       %
% % % %%%%% %%% % % % %.%%%%%%%%%%%%%
% % %   %  .  %.% % %  ..   % . % % %
% % %%% %%% % %.% %%%%%%%%%.%%%.% % %
% %   % %   %.% %P. % %  .%.% %     %
% %%%.%%% %%% %.%%%.% % %%%%% % %%%%%
%.  .   %   %     %..     %.. % %   %
%%% % %%%%% %%%%% %%% %%% % %%% %.%%%
% % % % % % % %    .%.%   % %   % % %
% %.%%% % % % % %%%%%%%%% % %.% % % %
% .  .  %    . ..      .     .%     %
% % . % %%% %%% %%%%%%% %%% %%% %%% %
%.%   %       %.   .      %.    %. .%
%%%%%%%%%%%%%%%%%%%%%%%%%%%%%%%%%%%%%