%%%%%%%%%%%%%%%%%%%%%%%%%%%%%%%%%%%%%
%.      %          . . .          %.%
%    .    %%%%% % %%% %%% %%%%%%% % %
%       %  .    % %.  . %    .% %  .%
%%%%%.%%%%% %%% % % % %%% %%%%% % %%%
%   % % %.%   % % % %  .% %     % . %
% %%% %.% % %%% %%%%% %%% %.%%% %%% %
%     . %     %   %   %   . % %.%.  %
%%%.%%%%%%%%% %%%%%%% %%% %%% %.% % %
%             %       % %   %     % %
% % %%%%% % %%% % % %%% %.%%% %%% % %
% % %     % % % % %     % . %.% % % %
% %.% %%%%%%% % %%%%%%%%% %%% % %%% %
% % % %     %   %     %     %   %   %
%%% %%% % %%%%% %%%%% %%% %%% %%%%% %
%     % %.      .  .   .% %   % % % %
%.%.% % %  %  %%% %%% %%% % % % % % %
%.% %.% % %%    % %   %   % % %.  . %
% % %%%%%  %  %%% %%% % %%% %%% %%%%%
%       %. % .  % %.  %       % %   %
%.%%% % %  %  %%% %%%.%%%%%%%%% % %%%
%   % %           .  .    %   % % . %
% %%% %%%%%%%%%%%%%%%%%%%%% % % %%% %
% %..          .            %  .    %
% % % %%%%% %%% % % % % %%%%%%%%%%%%%
% % %   %  .  % % % %       %  .% %.%
% % %%% %%% % % % %%%%%%%%% %%% % % %
% %   % %   % % %P  % %   % %.%     %
% %%% %%% %%% % %%% % % %%%%% %.%%%%%
%       %   %  .  %       % . % %   %
%%% % %%%%% %%%%% %%% %%% % %%% % %%%
% % % % % % % %    .% %   % %  .% % %
%.% %%% % % % % %%%%%%%%% % % % % % %
% . .   %              .      %     %
% %   % %%% %%% %%%%%%% %%% %%% %%%.%
%.%.  %       %.          %     %  .%
%%%%%%%%%%%%%%%%%%%%%%%%%%%%%%%%%%%%%