%%%%%%%%%%%%%%%%%%%%%%%%%%%%%%%%%%%%%
%. ..   %.%.%. .. .     %   %     %.%
% %%%%%%% % %%% %.%%% %%% %%%%%%% % %
%. .   .%.    ..% %.  . %     %.%   %
%%%%% %%%%% %%% %.% % %%% %%%%% %.%%%
%   % % % %.  %.% % %.  % %.. % %  .%
%.%%%.% % % %%% %%%%% %%%.% %%% %%%.%
% .    .% ..  %   %  .%   ..% % %   %
%%% %%%%%%%%%.%%%%%%%.%%%.%%%.% % % %
%.    ....  . % . . ..% %.  %. .  % %
% % %%%%%.% %%%.% % %%% %.%%% %%%.% %
% % %.   .% %.% % %  . .% ..% % %.%.%
% % % %%%%%%% % %%%%%%%%% %%% % %%% %
% % % %.    %   % .   %   . %  .% . %
%%% %%% %.%%%%%.%%%%%.%%% %%% %%%%%.%
%.. . % %.%     % %. .  % %   % % % %
%.% % % %.%%% %%% %%%.%%% % % % % % %
% % % % %    .  .... .. ..% % %    .%
%%%.%%%%%%% % %.%%%%% %%% % %%% %%%%%
% .   . %.% % %     %  .%    .%.% . %
%%%%% % % %%%%%%%%%.%%%%%%%%%%% % %%%
%   %.%.. .  .   .% %   . % ..% %.  %
% %%%.%%%%% %%%%%%%%% %%%%% %.% %%% %
% %   %  .   %  ..  . % .  .%    .  %
%.%.%.%%%%% %%% % % % % %%%%%%%%%%%%%
% %.%. .%. .  % % % %  .    %   % % %
% % %%%.%%%.% % % %%%%%%%%% %%% % % %
% %  .%.% . % % %.. % %  .% % %     %
% %%% %%% %%%%% %%%.%.% %%%%%.% %%%%%
%. .    %.. %    .%.%   ..%.  % %.. %
%%% % %%%%% %%%%% %%% %%% % %%% %.%%%
% % % % % %.% %    .% %   %.%   %.% %
%.% %%% %.% %.% %%%%%%%%% % % %.%.%.%
%.. %. .%...%.. .        .    %  ...%
%.% %.% %%% %%% %%%%%%%.%%%.%%% %%%.%
%P%P% %     . % ..% .  .  %   % %PP %
%%%%%%%%%%%%%%%%%%%%%%%%%%%%%%%%%%%%%