%%%%%%%%%%%%%%%%%%%%%%%%%%%%%%%%%%%%%
%.      %      ..   ..  .   . PPPP%.%
%     .   %%%%% %.%%% %%% %%%%%%%.% %
% .  .  % .    .%.%     %.  . % %   %
%%%%% %%%%% %%%.% % % %%% %%%%% % %%%
%   %.%.% %   %.%.% %.. % % .   %   %
% %%% % % % %%% %%%%% %%% % %%% %%% %
%     . %   ..%.  % . %   . % % %.. %
%%%.%%%%%%%%% %%%%%%% %%% %%%.% % % %
%        .  . % .     % %   % .   % %
% % %%%%% % %%% % %.%%% % %%%.%%% % %
% % %     % %.%.%.%  .  %   %.% % % %
%.% % %%%%%%% % %%%%%%%%%.%%% % %%% %
% %.% %     %.  %   . %     % . %.  %
%%% %%% % %%%%% %%%%% %%% %%% %%%%%.%
%     % %               % % . % % % %
% %.% % %  %  %%%.%%% %%%.%.% % % % %
% % % % % %%  . % %   %   % % % .  .%
% %.%%%%%  %  %%% %%% % %%% %%% %%%%%
%       %  %    % %   % ..    % %   %
% %%% % %  %. %%% %%% %%%%%%%%% %.%%%
%   % % . .           .   % . %.%.. %
% %%%.%%%%%%%%%%%%%%%%%%%%%.% %.%%% %
% %.     ..  .    .   ..   .%     . %
%.% % %%%%% %%% %.% % % %%%%%%%%%%%%%
% %.%   %..  .% % % %       %   % %.%
% % %%% %%%.% % % %%%%%%%%% %%% %.%.%
% %.  % %   % % %P .% %   % % %   . %
%.%%%.%%% %%%.% %%%.% % %%%%% %.%%%%%
%       %   % ..  %   . . % . %.% . %
%%%.% %%%%% %%%%% %%% %%% % %%% % %%%
% % % % % % % %  . .%.% . % %   %.% %
%.%.%%% % %.%.% %%%%%%%%% % %.% % % %
%   . . %      .    . .       %     %
%.%.  % %%%.%%% %%%%%%% %%% %%% %%% %
%.%   %   .   %           %     %  .%
%%%%%%%%%%%%%%%%%%%%%%%%%%%%%%%%%%%%%