%%%%%%%%%%%%%%%%%%%%%%%%%%%%%%%%%%%%%
%..     % ... .     ..  .     PPPP%.%
% . .. .  %%%%%.% %%% %%% %%%%%%% % %
%.   .. %    .  %.%..   %    .% %.. %
%%%%%.%%%%% %%% % % % %%% %%%%%.%.%%%
%   %.%.% %  .%.%.% %  .% % .   %. .%
% %%% % % %.%%% %%%%% %%% %.%%%.%%% %
%.  . . %  .  %.. %  .% ..  % % %.  %
%%% %%%%%%%%% %%%%%%% %%% %%%.% % % %
%  ..  .     .% ..  ..% %   %..  .% %
%.% %%%%% % %%% % % %%%.%.%%%.%%% % %
% %.%  .  % % % % %     %.. % %.% % %
% % % %%%%%%% % %%%%%%%%% %%% % %%% %
%.% % %   ..%   %    .%     %. .%.  %
%%%.%%% % %%%%%.%%%%%.%%%.%%%.%%%%%.%
% ....% %..   .    . .  %.%   %.% % %
%.% % % %  % .%%% %%% %%%.% %.% % %.%
%.% % %.%.%%. ..% % . %  .%.% %.    %
% %.%%%%%. %  %%%.%%% % %%% %%% %%%%%
%.  . . % .% .  % %   %   .  .% %   %
% %%%.% %  % .%%% %%% %%%%%%%%% %.%%%
%   % %  .. .    .  ..    %   % % . %
% %%% %%%%%%%%%%%%%%%%%%%%%.% % %%% %
%.%   .       .  . .   .    % .   . %
% % % %%%%% %%% %.%.% % %%%%%%%%%%%%%
% % %.  %     % %.% %  ..   %   % % %
% %.%%%.%%% %.%.% %%%%%%%%%.%%% %.% %
% %  .% %   % % %P. %.%.  % %.%     %
%.%%% %%% %%% % %%% % %.%%%%% % %%%%%
%      .% ..%     %  .    % ..% %. .%
%%% % %%%%% %%%%% %%%.%%% % %%% % %%%
% % % % % % % %.    % % . % %   % % %
%.% %%%.%.%.%.%.%%%%%%%%%.% % % % % %
%      .%    .     .         .%    .%
%.%. .%.%%% %%% %%%%%%%.%%% %%%.%%% %
%.% . % ... ..%  .   . . .%   ..%. .%
%%%%%%%%%%%%%%%%%%%%%%%%%%%%%%%%%%%%%