%%%%%%%%%%%%%%%%%%%%%%%%%%%%%%%%%%%%%
%      .  .   .               .   .P%
% . ..   .   %..  .   .    . .    . %
%.   ..      %.   . ...     ..   .  %
% .   . . .  %.  .      ..    . . . %
%   . ..     %. . ..         .  .   %
%       .    %        ...  .    .   %
%            %      %. .    ..      %
%            %   .. %  . . .    ... %
%  .         %      %      .        %
%    .      .% P.   %             . %
%   .  .     %  .   %     ..        %
%.  ..    .  %   .  % .   .         %
%   ...   .  %  . . %   .     ..  ..%
%%%%%%%%%%%%%%.     %%%%%%%%%%%%%%%%%
%   .  .  .  % ... .  .         .   %
% .       .  % .     . .    .      .%
% ..     ..  %      .  .  .        .%
%                    .   .          %
%.  .          .            .       %
%          .       . .  ..          %
%.        .    .       .        ..  %
%%%%%%%%%%%%%%%%%%%%%%%%%%%%%%%%%%%%%