%%%%%%%%%%%%%%%%%%%%%%%%%%%%%%%%%%%%%
%.    . %                     PPPP%.%
%      .  %%%%% %.%%%.%%% %%%%%%% % %
%       %.      % %    .%     %.%.  %
%%%%% %%%%% %%% % % % %%% %%%%% % %%%
% . % % % %   % % % % . % %  .  %   %
% %%% % % % %%% %%%%% %%% % %%% %%% %
%       %     %   %   %     % %.%  .%
%%% %%%%%%%%% %%%%%%% %%% %%% % % % %
%    .        %       % %.  %  .  % %
% % %%%%% % %%% % % %%% % %%%.%%% % %
% % %     % % % % %     % . % % % % %
% % % %%%%%%%.% %%%%%%%%% %%% % %%% %
% % % %    .%   % . . %     %   %   %
%%% %%% %.%%%%% %%%%% %%% %%% %%%%% %
% .   % %               % %   % % % %
% % % % %  %  %%% %%% %%% % % % % % %
% %.% %.% %%    % %   %. .% % %     %
% % %%%%%  %  %%% %%% % %%% %%% %%%%%
%       % .%.   %.%.. %      .% %   %
% %%% % %  %  %%% %%%.%%%%%%%%% % %%%
%   % %             .     %   % %.  %
% %%% %%%%%%%%%%%%%%%%%%%%% % % %%% %
% %  .                   .  % .     %
% % % %%%%% %%% % % % % %%%%%%%%%%%%%
% % %  .%     % % % %    .  %   % % %
% % %%% %%%.% %.% %%%%%%%%% %%% %.% %
% %  .% %   % % %P  %.%   % % %  .  %
% %%% %%% %%% %.%%% % % %%%%% %.%%%%%
%       % . %     %       %   % %   %
%%% % %%%%% %%%%% %%% %%% % %%% % %%%
% % % % % %.% %     % %  .% %.  %.% %
% % %%% % % % % %%%%%%%%% % % % % % %
%      .%                     % .   %
% %   % %%% %%% %%%%%%% %%%.%%% %%%.%
%.%   %       %           % . ..% ..%
%%%%%%%%%%%%%%%%%%%%%%%%%%%%%%%%%%%%%