%%%%%%%%%%%%%%%%%%%%%%%%%%%%%%%%%%%%%
%.     .% %.%  . ..   ..% . %.  . % %
% %%%%%%% % %%%.%.%%% %%% %%%%%%% %.%
%  .   .%   .   % %.    %. . .% %   %
%%%%% %%%%% %%% % % % %%%.%%%%% % %%%
% ..%.%.%.%.  % % %.%.  % % ..% %   %
%.%%% % % % %%%.%%%%%.%%%.% %%%.%%% %
%...    %    .% . % . %     % % %   %
%%% %%%%%%%%% %%%%%%% %%% %%%.% % % %
% ...         %. .. ..%.%  .% .  .% %
%.%.%%%%%.% %%% % % %%% %.%%% %%% % %
%.% %.    %.% %.% %.  ..%.. % %.% % %
%.% %.%%%%%%% % %%%%%%%%%.%%% % %%% %
%.%.%.%.  . %   %..  .% . ..% ..%.  %
%%% %%% % %%%%%.%%%%% %%% %%% %%%%% %
% .  .%.% %. .. % %   ..% %   % %.% %
% % %.%.% %%% %%%.%%% %%% % % % %.% %
% % %.% % ..    ..      . % %.%  .  %
%%% %%%%%%% % % %%%%%.%%% % %%% %%%%%
% .     % % % %    .%  .%     % %...%
%%%%%.% % %%%%%%%%% %%%%%%%%%%% % %%%
%  .%.%.  .     . % %.    %   % %   %
% %%% %%%%%.%%%%%%%%% %%%%%.% % %%%.%
%.% . %      %      . %. ...%  .  . %
% % %.%%%%% %%% % % % % %%%%%%%%%%%%%
% %.%.  % .  .% %.%.%  .  ..%   %.%.%
% % %%% %%% %.% %.%%%%%%%%% %%% % % %
% %   % %   % % %   %.% . % % % . . %
% %%% %%% %%%%% %%%.% % %%%%% % %%%%%
%.   .. %  .%  .  % % .  .% . % %  .%
%%% % %%%%% %%%%% %%% %%%.% %%% % %%%
% % % % % % %.% .   %.%   % %. .% % %
% %.%%% % %.% % %%%%%%%%% % % % % % %
% . %   %.. %.   ...  . .    .%.    %
% % % %.%%% %%% %%%%%%%.%%% %%%.%%%P%
%.%.% %   .   % . % . ... %   % %PPP%
%%%%%%%%%%%%%%%%%%%%%%%%%%%%%%%%%%%%%