%%%%%%%%%%%%%%%%%%%%%%%%%%%%%%%%%%%%%
%..     %  . .   .    .       PPPP%.%
%         %%%%% % %%% %%% %%%%%%% % %
%  .    %       % %  . .%  .  % %   %
%%%%% %%%%% %%% % % % %%%.%%%%% % %%%
%.  % % % %   % % % %   % %     %   %
% %%% % % % %%% %%%%% %%% % %%%.%%% %
%       %     %   %   %.    %.% %.  %
%%% %%%%%%%%% %%%%%%% %%% %%% % % % %
%      .      %  .    % %   %     % %
% % %%%%%.% %%% % % %%% % %%% %%% % %
% % %     % % % % %     %   % % % % %
% % % %%%%%%% % %%%%%%%%% %%% % %%% %
% % %.%   . %   %     %     %   %   %
%%% %%% % %%%%% %%%%% %%% %%% %%%%% %
%.  . % %               % %  .% % %.%
%.% %.% %  %  %%% %%% %%% % % % % % %
% % % %.% %%. . % %   %. .% % %    .%
%.% %%%%%. % .%%% %%% % %%% %%% %%%%%
% .   . %  %    % %   %       % %   %
% %%% % %  %  %%% %%% %%%%%%%%%.% %%%
%   % % .              .  %   % %. .%
% %%%.%%%%%%%%%%%%%%%%%%%%% % %.%%% %
% %             .         . %       %
% % % %%%%% %%% % % % % %%%%%%%%%%%%%
% % %   %     % % % %       %   % % %
% % %%% %%% % % % %%%%%%%%%.%%% % % %
% % . % % . % % %P  % %   % % %     %
% %%% %%% %%% % %%% % % %%%%% % %%%%%
%   . . % ..%     %       %   % %   %
%%% % %%%%% %%%%% %%% %%% % %%% %.%%%
% % % % % % % %     %.%   % %   % % %
%.% %%% %.% % % %%%%%%%%% % % % % % %
%  .    %   . .               %     %
% %   % %%% %%% %%%%%%% %%% %%% %%% %
%.%   %       %      . .. %     %  .%
%%%%%%%%%%%%%%%%%%%%%%%%%%%%%%%%%%%%%