%%%%%%%%%%%%%%%%%%%%%%%%%%%%%%%%%%%%%
%.      % % % .       ..%. .% .   % %
% %%%%%%% % %%%.%.%%% %%% %%%%%%% % %
% ... . %  .  . % %    .% .   % %.  %
%%%%% %%%%% %%% %.% %.%%% %%%%% % %%%
% . % % %.%   % % % % ..% %   % %  .%
% %%% % % % %%%.%%%%%.%%% %.%%% %%% %
%       % . . %   %   %    .%.% %  .%
%%% %%%%%%%%% %%%%%%%.%%% %%% % % % %
%             %   . ..% %.  %     %.%
% % %%%%% % %%% % % %%% % %%% %%%.% %
% % %  .  % %.%.% %     %   % % % %.%
% %.% %%%%%%% % %%%%%%%%%.%%% % %%%.%
% % % %.    %.  %   ..%     %   %.  %
%%% %%% % %%%%% %%%%%.%%% %%%.%%%%%.%
%  .  % % %  .. % %     % %. .% % % %
% % % % % %%% %%% %%% %%% % %.% % % %
% % % % % . .            .% % %.  . %
%%% %%%%%%% %.%.%%%%% %%% % %%%.%%%%%
%.  .   % % % %. ...%.  %     % %   %
%%%%%.% % %%%%%%%%% %%%%%%%%%%% % %%%
%   %.%.  .       %.% .   %.  % %   %
% %%% %%%%% %%%%%%%%% %%%%% %.% %%% %
% %   %     .%.       %     %   .   %
% % % %%%%% %%%.% % % %.%%%%%%%%%%%%%
% % %   % .   % % % %    .. %  .% % %
% % %%%.%%% % % % %%%%%%%%%.%%% %.% %
% %.  % %   % % %.  % %   % % %     %
% %%% %%% %%%%% %%%.%.% %%%%% %.%%%%%
% .    .%   %..   % %    .%   %.%.  %
%%% % %%%%% %%%%% %%%.%%% % %%% %.%%%
% %.% % % % % %     % % . % %   % % %
% % %%%.% % % % %%%%%%%%% % % % % %.%
%   %   % . %  .   .. . .   . %.    %
% % % % %%%.%%% %%%%%%% %%% %%%.%%% %
%P%P% % . .   %   %. .    %   %.%PP %
%%%%%%%%%%%%%%%%%%%%%%%%%%%%%%%%%%%%%