%%%%%%%%%%%%%%%%%%%%%%%%%%%%%%%%%%%%%
%      .% %.%      .    % . %     % %
% %%%%%%% % %%% % %%% %%% %%%%%%% % %
%       %       %.%     %     % %   %
%%%%% %%%%% %%% % % %.%%% %%%%% % %%%
%   % % % %   % % % %   % % . % %   %
% %%% % % % %%% %%%%% %%% % %%% %%% %
%    .  % .  .%   %   %  .  % % %  .%
%%%.%%%%%%%%% %%%%%%% %%% %%% % % %.%
%             %  .    % %   %     % %
%.% %%%%% % %%% % % %%% % %%% %%% % %
% %.%     % % % % %     %   % % % % %
% % % %%%%%%% % %%%%%%%%% %%% % %%% %
% % % %     %   % ..  %     %   %   %
%%% %%% % %%%%% %%%%% %%% %%% %%%%% %
% .   % % %. .  % %     % %   % % % %
% %.% %.% %%% %%% %%% %%% % %.% % % %
% % % % %                 % % %     %
%%% %%%%%%% % % %%%%% %%% % %%% %%%%%
% .     % %.% % .   %   %    .% %   %
%%%%% % % %%%%%%%%% %%%%%%%%%%% % %%%
% . %.%      .   .% % .   %  .% % . %
% %%% %%%%% %%%%%%%%% %%%%% % % %%% %
% %   %   .  %        %  .  %.      %
% % %.%%%%%.%%% % % % % %%%%%%%%%%%%%
% % % . %     % %.%.%  .    %   % % %
% % %%% %%% % % % %%%%%%%%% %%% % % %
% %   % %  .%.% % . % %   % % %     %
% %%% %%% %%%%% %%%.% % %%%%% % %%%%%
%       % . %     % %    .%   % %   %
%%% % %%%%% %%%%% %%%.%%% % %%%.% %%%
% %.%.% % % % %   . % %   % %   % % %
% % %%% % %.% % %%%%%%%%% % %.% % % %
%   %   %   %             .  .%     %
% % % % %%% %%% %%%%%%%.%%% %%% %%%P%
%.%.% %    .  %   %       %   % %PPP%
%%%%%%%%%%%%%%%%%%%%%%%%%%%%%%%%%%%%%