%%%%%%%%%%%%%%%%%%%%%%%%%%%%%%%%%%%%%
%       % % %        .  %  .%  . .% %
% %%%%%%% % %%% % %%% %%% %%%%%%% % %
%  .    %      .% %    .%     % %   %
%%%%% %%%%% %%% % % % %%% %%%%% % %%%
%   %.% % %   % % % %.. % %   % %   %
% %%% % % % %%% %%%%% %%% %.%%% %%% %
%..     %    .%. .%   %     % %.%   %
%%% %%%%%%%%% %%%%%%% %%% %%% %.% % %
%             %     . % %   %     % %
%.% %%%%%.% %%% % % %%% %.%%% %%% % %
% % %  .  % % % % %     %   % % % % %
%.% % %%%%%%% % %%%%%%%%% %%% % %%% %
% % % %     %   %     %   . %  .%   %
%%% %%% % %%%%% %%%%% %%% %%%.%%%%% %
%     % % % .   % %     %.%   % %.% %
% % % % % %%% %%% %%% %%% % % % % % %
% %.% % %        .      . %.% %     %
%%% %%%%%%% % % %%%%% %%% % %%% %%%%%
%.      % % % %   . %.  %     % %   %
%%%%% % % %%%%%%%%% %%%%%%%%%%% % %%%
%   % %       . . % %     %   % %.  %
% %%% %%%%% %%%%%%%%% %%%%% % % %%% %
% %.  %   .  %        %     %     . %
% % % %%%%% %%% % % % % %%%%%%%%%%%%%
% % %   %     %.% %.%       %.  % % %
% % %%% %%% % % % %%%%%%%%% %%% % % %
% %   % %.  %.% %   % %   % % %     %
% %%% %%% %%%%% %%% % % %%%%% % %%%%%
%       %   %    .% %    .% . % %  .%
%%%.% %%%%% %%%%% %%% %%% %.%%% % %%%
% % % % %.% % %    .% %.  % %   % % %
% % %%% % % % % %%%%%%%%% % %.% % % %
%   %  .% . %                 % .   %
% %.% % %%% %%% %%%%%%% %%% %%% %%% %
%P%P% %   ..  %   %       %   % %PP %
%%%%%%%%%%%%%%%%%%%%%%%%%%%%%%%%%%%%%