%%%%%%%%%%%%%%%%%%%%%%%%%%%%%%%%%%%%%
%. .  . % .   .    .. .  ..    .  %.%
%..   .. .%%%%% % %%% %%%.%%%%%%%.%.%
%.... . %. .  . %.%   . %    .% %  .%
%%%%% %%%%% %%%.% % %.%%%.%%%%% % %%%
%.  %.%.% %.  % % % %.. %.%     %   %
% %%%.%.% % %%% %%%%% %%% % %%% %%%.%
%. .  . %  . .% ..%   %. . .%.% % ..%
%%% %%%%%%%%%.%%%%%%% %%%.%%% % %.%.%
% .. .   .    %.   .. % %   %     %.%
% %.%%%%% % %%% % %.%%% % %%% %%% % %
% %.%.   .%.%.% % %     %. .% % %.% %
% % % %%%%%%% %.%%%%%%%%%.%%% % %%% %
%.% %.%     %   %.   .%.   .%   %  .%
%%%.%%% %.%%%%%.%%%%% %%% %%%.%%%%% %
%. .. % %.        .     % %   % % % %
% %.%.%.%  %  %%% %%% %%% %.%.%.% %.%
%.%.%.% % %%    % %  .%   % % %    .%
% %.%%%%% .%  %%%.%%% % %%% %%% %%%%%
%. .  ..%  %  . % % . % .    .% %  .%
% %%% % %  %  %%% %%% %%%%%%%%% % %%%
%   % %.       .  .  .    %   %.%   %
% %%%.%%%%%%%%%%%%%%%%%%%%% %.% %%% %
% %        .  ..  . .  .. . % .     %
%.% % %%%%% %%% %.% % % %%%%%%%%%%%%%
% %.% . %.   .% %.%.% .     %   % % %
% %.%%%.%%% %.% % %%%%%%%%% %%% % % %
% % . %.%.. % %.%P  %.%   % % %   . %
%.%%% %%% %%%.% %%%.% %.%%%%% %.%%%%%
%      .%   %     %.  .   %.  % %.  %
%%% % %%%%% %%%%% %%% %%%.% %%%.% %%%
%.% % %.% %.% %    .% %   % % . % %.%
% % %%%.%.% % % %%%%%%%%%.% % % % % %
%      .%.. ......  .  .      %.  . %
%.%.  % %%% %%% %%%%%%% %%% %%% %%% %
%.% ..%.  ..  %   .       %   ..%  .%
%%%%%%%%%%%%%%%%%%%%%%%%%%%%%%%%%%%%%