%%%%%%%%%%%%%%%%%%%%%%%%%%%%%%%%%%%%%
%..  ...%  ..       . .     ..PPPP%.%
%     .. .%%%%% %.%%% %%%.%%%%%%% %.%
%.     .%  .    % %  .. %.  ..%.%   %
%%%%% %%%%% %%%.% %.% %%% %%%%% % %%%
%.  % %.% %   % % % %   % % . . % . %
% %%%.% % % %%%.%%%%% %%% % %%%.%%% %
%     . %.  . %   % ..%     % % %   %
%%% %%%%%%%%% %%%%%%%.%%% %%% % % % %
% . .        .%..     %.%.  % ..  % %
%.% %%%%% %.%%% %.% %%%.%.%%%.%%%.% %
% % % .. .% % % % %  .  %.  % % % % %
% % %.%%%%%%%.%.%%%%%%%%% %%% % %%% %
% % % %  .  %. .%   . %    .%.. %.. %
%%% %%% % %%%%% %%%%%.%%% %%% %%%%% %
%.   .% % ..        . . % %  .%.% %.%
%.%.%.% % .% .%%%.%%%.%%% % %.% % %.%
% % % % %.%%  ..% %   %   % % %... .%
% % %%%%%  %..%%% %%% % %%% %%% %%%%%
%.  .   %. %    % % ..%.     .% % . %
%.%%% % % .% .%%%.%%% %%%%%%%%%.% %%%
%.  % %  .      . ...     %   % % . %
% %%% %%%%%%%%%%%%%%%%%%%%% %.% %%%.%
%.%     . . .  .   .     .. %     ..%
% % % %%%%% %%% % % % % %%%%%%%%%%%%%
%.% %  .%.  . % % % %      .%  .% % %
% % %%% %%% %.%.%.%%%%%%%%% %%% % %.%
%.%   % % . % % %P. % %. .%.% %  .  %
%.%%% %%%.%%% %.%%% % % %%%%% %.%%%%%
%   . . %   % . . % .     %.  %.% . %
%%% % %%%%% %%%%% %%% %%% %.%%% % %%%
% %.%.% %.% % %.  . %.%.. % %   % % %
% % %%%.% % % % %%%%%%%%% % % %.% %.%
%       %.. .  ..    . . .   .%.  . %
% %   % %%% %%% %%%%%%%.%%% %%% %%%.%
%.%. .%  .  . %. ..      .%   . % ..%
%%%%%%%%%%%%%%%%%%%%%%%%%%%%%%%%%%%%%