%%%%%%%%%%%%%%%%%%%%%%%%%%%%%%%%%%%%%
%                                  P%
%            %                      %
%            %                      %
%            %                      %
%            %                      %
%            %                      %
%            %      %               %
%            %      %               %
%            %      %               %
%            %      %               %
%            %      %               %
%            %      %               %
%            %      %               %
%%%%%%%%%%%%%%      %%%%%%%%%%%%%%%%%
%            %                    P %
%            %                      %
%            %                      %
%                                   %
%                                   %
%                                   %
%.                                . %
%%%%%%%%%%%%%%%%%%%%%%%%%%%%%%%%%%%%%
