%%%%%%%%%%%%%%%%%%%%%%%%%%%%%%%
%.    %          . .  . %   . %
%.%%% % %%% %%%%%%% %%% %     %
% %.  % %.. .  %. . . %.%  .. %
%.  %%% % %%%% % %%%%   %%%   %
%%% % % % %. .   %  % %   %.%%%
%.  % %%% % %%% %%% % %%%.%  .%
% %%%       % .   %.   .  %%% %
%   % %%%%% %%%%%%% %.%%% % . %
%%% %.  % %    %    % %. .% %%%
%  .%%% % %%%% % %%%% % %%% ..%
%       %  . ..%. .. .%     % %
%     % %%% %%%%%%% %%% % %%% %
%PP   %  P   . P    % ..%  .  %
%%%%%%%%%%%%%%%%%%%%%%%%%%%%%%%