%%%%%%%%%%%%%%%%%%%%%%%%%%%%%%%
% .   %  ....           %     %
% %%% % %%% %%%%%%% %%% %  .  %
% %   % % .    %      % %     %
% . %%% % %%%% % %%%%   %%%   %
%%% % % % %      %  % %   % %%%
% . % %%% % %%% %%% % %%% %   %
% %%% ..    %     %   .   %%% %
% . % %%%%% %%%%%%% % %%% %   %
%%% %   % %    % .. % %   % %%%
%   %%% % %%%% % %%%% % %%%   %
%P      %      %  ..  %     % %
%  .. % %%% %%%%%%% %%% % %%% %
%     %  ..    P    %   %  .  %
%%%%%%%%%%%%%%%%%%%%%%%%%%%%%%%