%%%%%%%%%%%%%%%%%%%%%%%%%%%%%%%%%%%%%
%           .                      P%
%.           %                      %
%       .    %   .                  %
%            %        .     .     . %
%           .% . .           ..    .%
%.        ...%    .                 %
%            %      %       .     . %
%          . %    . %.        .     %
%            %.    P% .         .   %
%          . %      %               %
%.       .   %      %    .         .%
%  .   .   . %      %      .        %
%           .%      %      .   .    %
%%%%%%%%%%%%%%   .  %%%%%%%%%%%%%%%%%
%      ...   %           .          %
%    ..  .   %     .          .     %
%        .   %    ..                %
%    .     .            .           %
%        .     .  .                 %
% .  ..          .    . .           %
%. .      .                   .     %
%%%%%%%%%%%%%%%%%%%%%%%%%%%%%%%%%%%%%