%%%%%%%%%%%%%%%%%%%%%%%%%%%%
%      ...   %%    ...     %
% %%%% %%%%% %% %%%%% %%%% %
%o%%%% %%%%% %% %%%%% %%%%o%
% %%%% %%%%% %% %%%%% %%%% %
%        .   .  .. .       %
% %%%%.%% %%%%%%%% %% %%%% %
% %%%% %% %%%%%%%% %% %%%% %
%  .   %%    %%    %%      %
%%%%%% %%%%% %% %%%%% %%%%%%
%%%%%%.%%%%% %% %%%%% %%%%%%
%%%%%% %  .  . .    % %%%%%%
%%%%%% % %%%%  %%%% % %%%%%%
%        %  . .   %        %
%%%%%% % %%%%%%%%%% % %%%%%%
%%%%%% %   .    .   % %%%%%%
%%%%%% % %%%%%%%%%% % %%%%%%
%   ...    P %%    ..      %
% %%%% %%%%% %% %%%%% %%%% %
% %%%% %%%%% %% %%%%% %%%% %
%   %% . .   ..     . %%   %
%%% %% %% %%%%%%%% %% %% %%%
%%% %% %% %%%%%%%% %% %% %%%
%      %%    %%    %%  .   %
% %%%%%%%%%% %% %%%%%%%%%% %
%       ..    P    ...     %
%%%%%%%%%%%%%%%%%%%%%%%%%%%%
