%%%%%%%%%%%%%%%%%%%%%%%%%%%%%%%%%%%%%
%.  . . %  . .. .    .     . . . .%.%
%...      %%%%% % %%% %%% %%%%%%% % %
%       %  .    % %. .. % .   % %   %
%%%%% %%%%% %%% % % % %%% %%%%% % %%%
%   % % % % . % % % %   % %     %   %
% %%%.% % % %%% %%%%% %%% %.%%% %%% %
% .     %.  . %   %.  %     % % %. .%
%%%.%%%%%%%%% %%%%%%%.%%%.%%% % % % %
% . ..  .  .. %..     %.%   %. .  % %
%.% %%%%%.% %%% % % %%%.%.%%% %%% % %
% %.% .P  %.%.% % %     %   % % % % %
% % % %%%%%%% %.%%%%%%%%%.%%% % %%% %
% % % %     %   %     %     %   %   %
%%% %%% % %%%%% %%%%%.%%%.%%% %%%%% %
% .   % %  ..     . .   % %   % % % %
% %.%.% %  %  %%% %%% %%% % % % % % %
% % % % % %% .  % %.  %   % % %.  . %
% % %%%%%  % .%%%.%%%.% %%%.%%%.%%%%%
%       %. %    % %   %     . % %  .%
% %%%.% %  %  %%% %%%.%%%%%%%%% % %%%
%   % % .        . .      %.  % %.  %
% %%% %%%%%%%%%%%%%%%%%%%%% %.% %%% %
%.%   .  .    . ..         .%       %
% %.% %%%%% %%% % %.% %.%%%%%%%%%%%%%
% % %   %     % % % %       %   %.% %
% % %%% %%% %.%.% %%%%%%%%% %%% % % %
% %   %.%   % %.%P  % %   %.% %.  . %
% %%% %%%.%%%.%.%%% % % %%%%% % %%%%%
%. . .  % . %     %  .    %   % %   %
%%% %.%%%%% %%%%% %%% %%% % %%% % %%%
%.%.% % %.%.% %     % %   %.%  .% % %
% % %%% %.%.% % %%%%%%%%% % % % %.% %
%  . .  %     .           .   %.   .%
%.% . % %%% %%% %%%%%%% %%% %%% %%% %
%.%   %  .   .%.    ..    %    .%  .%
%%%%%%%%%%%%%%%%%%%%%%%%%%%%%%%%%%%%%