%%%%%%%%%%%%%%%%%%%%%%%%%%%%
% .         .%%            %
% %%%% %%%%% %% %%%%% %%%% %
%o%%%% %%%%% %% %%%%% %%%%o%
% %%%%.%%%%% %% %%%%% %%%% %
% ..         .             %
% %%%%.%% %%%%%%%% %% %%%% %
% %%%% %% %%%%%%%% %% %%%% %
%      %%    %%.   %%      %
%%%%%% %%%%% %% %%%%% %%%%%%
%%%%%% %%%%% %% %%%%% %%%%%%
%%%%%% %P      .    % %%%%%%
%%%%%% % %%%%  %%%% % %%%%%%
%        %.      .%     .  %
%%%%%% %.%%%%%%%%%%.% %%%%%%
%%%%%% %    .       % %%%%%%
%%%%%% % %%%%%%%%%% % %%%%%%
%          . %%            %
% %%%% %%%%% %% %%%%% %%%% %
% %%%%.%%%%%.%%.%%%%% %%%%.%
%   %%        ..      %%.. %
%%% %% %% %%%%%%%% %% %% %%%
%%% %% %%.%%%%%%%% %%.%% %%%
%      %%    %%.   %%      %
% %%%%%%%%%%.%% %%%%%%%%%% %
%             P           .%
%%%%%%%%%%%%%%%%%%%%%%%%%%%%