%%%%%%%%%%%%%%%%%%%%%%%%%%%%%%%%%%%%%
%.      %    ..           .       %.%
%         %%%%% % %%% %%% %%%%%%% %.%
%      .%       % %.    %     % %   %
%%%%% %%%%% %%% % % % %%% %%%%% % %%%
%   % % % %   % % % %   % %     %   %
% %%% % % % %%% %%%%% %%% % %%% %%% %
%       %    .%   %   %     % % %   %
%%% %%%%%%%%% %%%%%%% %%% %%%.% %.% %
%             %  .    % %   %   . % %
% % %%%%% % %%% % % %%% %P%%% %%%.% %
% % %     % % % % %     %   % % % %.%
% % % %%%%%%% % %%%%%%%%% %%% % %%% %
% %.%.%    .%   %  .  %  .  %   %   %
%%% %%% % %%%%% %%%%% %%% %%% %%%%% %
%     % %       ..      % % . % % % %
%.% %.% %  % .%%% %%% %%% % % % %.% %
% % % %.% %%.   % %.  % . % % %     %
% % %%%%%  %  %%% %%%.% %%% %%% %%%%%
%  .    %. %  . % %   % ..    % %   %
% %%% % %  %  %%% %%% %%%%%%%%% % %%%
%   % %               .. .%  P% %   %
% %%% %%%%%%%%%%%%%%%%%%%%% %.% %%% %
% %.              .  .      %       %
%.% % %%%%% %%%.% % % %.%%%%%%%%%%%%%
% % %   %     % % % %       % . % % %
% % %%% %%% % % % %%%%%%%%% %%% % % %
% % . % % . % % %P  % %.  % % %     %
% %%% %%% %%% % %%% % % %%%%% % %%%%%
%    P  %   %  .  %       %   % %   %
%%% % %%%%% %%%%%.%%% %%%.%.%%%.% %%%
% % % % % % % %     % %  .% %   % %.%
% % %%%.% % % % %%%%%%%%% % % %.%.% %
%       %                     %   . %
% %   % %%% %%% %%%%%%%.%%% %%% %%% %
%.%   %       % .         %   . %  .%
%%%%%%%%%%%%%%%%%%%%%%%%%%%%%%%%%%%%%