%%%%%%%%%%%%%%%%%%%%%%%%%%%%%%%%%%%%%
%.  P.  %  .  .        . .   .   .%.%
% .     ..%%%%% % %%% %%%.%%%%%%% %.%
%   . . %.  .  .% %... .% .   % %  .%
%%%%% %%%%%.%%%.% % % %%% %%%%% % %%%
%   %.% % %.  % % % %   % %    .%  .%
% %%% % % % %%% %%%%% %%% % %%%.%%% %
% .     %    .%.  %.  %     % % % . %
%%%.%%%%%%%%% %%%%%%% %%% %%% % % %.%
%.. .      .. %    .  % %..P%  . .% %
%.% %%%%% % %%% %.% %%%.% %%% %%% % %
%.% %...  %.%.% %.% ... %.  % % %.% %
% % % %%%%%%%.% %%%%%%%%% %%% % %%%.%
% % % %    .%   %    .%.    %  .%...%
%%% %%% %.%%%%% %%%%% %%% %%%.%%%%% %
%...  % % .   .    ..   % %   % % % %
% % % % % .%  %%% %%%.%%% % %.% %.%.%
%.% % % % %%    %.% . %  .% %.%    .%
% % %%%%% .%  %%% %%% %.%%%.%%% %%%%%
%.  .   %  %.  .% %.. %  .  ..%.%  .%
% %%% % % .%  %%% %%% %%%%%%%%% % %%%
%   % %   ...   .   ....  %  .% %  .%
% %%% %%%%%%%%%%%%%%%%%%%%% % % %%% %
%.%           .   ..     .  %.  ....%
% %.% %%%%% %%% % %.% % %%%%%%%%%%%%%
% %.%  .%   . % % % %  .   .% ..% % %
%.% %%% %%% % % %.%%%%%%%%% %%% %.% %
% %.  % %  .%.%.%P  %.%   % % %     %
% %%% %%% %%% %.%%%.% % %%%%%.% %%%%%
%     ..% ..%  . .% .  .  %. .%.%   %
%%%.% %%%%% %%%%% %%% %%% %.%%%.% %%%
%.% % %.%.% % %   . %.%   %.%.. %.%.%
%.%.%%%.% %.%.% %%%%%%%%% %.% %.% % %
%    . .%...    ...    . .    %   ..%
%.%  .%.%%% %%% %%%%%%%.%%% %%% %%% %
%.%   %   ..  %       .P  %  .  %. .%
%%%%%%%%%%%%%%%%%%%%%%%%%%%%%%%%%%%%%