%%%%%%%%%%%%%%%%%%%%%%%%%%%%%%
%.   .  % % %              %.%
%       % % %%%%%% %%%%%%%.% %
%       %    .   %    .%.%   %
%%%%% %%%%% %%% %% %%%%% % %%%
%  P% %.% %   %    %.    %   %
% %%% % % % %%%%%%%% %%% %%% %
%   .   %     %%     % % % ..%
%%% % %%%%%%%.%%%% %%% % % % %
% %           %%     %     % %
% % %%%%% % %%%% % %%% %%%.% %
%   %     %    . % %   % %%% %
%.  %P%%%%% .  . % %%% %    .%
%%%%%%%%%%%%%%%%%%%%%%%%%%%%%%