%%%%%%%%%%%%%%%%%%%%%%%%%%%%%%%%%%%%%
%   .   %.%.%...      . %.  % .   %.%
%.%%%%%%% % %%% %.%%%.%%% %%%%%%% % %
%   .   %  .    % %   . %. ...% %   %
%%%%% %%%%%.%%% % % % %%%.%%%%% %.%%%
%...% % %.%.  % %.% %. .%.%  .%.%   %
% %%% % %.% %%%.%%%%% %%%.%.%%%.%%% %
%      .%     %   %. .%     % % %.. %
%%%.%%%%%%%%% %%%%%%%.%%% %%% % % %.%
%..    .   .  %       %.%. .%     % %
% % %%%%% %.%%% %.% %%% % %%% %%% %.%
% % % ....% % % %.%    .%  .% % % %.%
% %.%.%%%%%%%.% %%%%%%%%% %%% %.%%% %
% %.% %...  %.  %   . % ..  %.  %   %
%%%.%%% %.%%%%% %%%%% %%% %%% %%%%% %
%    .% % %     % %  .  % %   % %.% %
% % % %.% %%%.%%% %%% %%%.% % % % %.%
% % % %.% . . .  ...   .  %.%.%.  . %
%%% %%%%%%% % % %%%%%.%%% % %%% %%%%%
%  .. . %.%.% %.    %.  %     % %   %
%%%%%.%.% %%%%%%%%% %%%%%%%%%%% %.%%%
% . % % ..    .   %.%.. . %   % %.. %
% %%% %%%%% %%%%%%%%% %%%%% % % %%% %
% %. .%.     % . .    %   . %    .  %
% % % %%%%%.%%% %.%.%.%.%%%%%%%%%%%%%
% %.% . %     % % %.%  . .. %   %.% %
% % %%%.%%%.%.%.% %%%%%%%%%.%%% % % %
% %.  % %.  % %.%.  %.%  .%.% %.. . %
%.%%% %%%.%%%%% %%% %.% %%%%%.% %%%%%
%    .  % . %    .% %..  .% . % %. .%
%%% % %%%%%.%%%%% %%% %%% % %%% %.%%%
% %.% %.% % % %.   .% %   %.% . % %.%
% % %%% % % % % %%%%%%%%% % % % % %.%
%   %.  %. .%   . . . .  .    %     %
%.% % % %%% %%% %%%%%%%.%%% %%% %%% %
%P%P% %  ..  .%   %.. .   %   % %PP %
%%%%%%%%%%%%%%%%%%%%%%%%%%%%%%%%%%%%%