%%%%%%%%%%%%%%%%%%%%%%%%%%%%%%%%%%%%%
%   .   %.% %   .   .   % . %     % %
% %%%%%%% % %%% % %%% %%% %%%%%%%.% %
%   .. .%       % %...  %     %.%.  %
%%%%% %%%%% %%% % % % %%% %%%%% % %%%
% . % % %.%.. %.% % %...% %  .% %   %
% %%% % % % %%%.%%%%% %%% %.%%% %%% %
%  . .  % . . %   % . % .  .%.% %   %
%%% %%%%%%%%% %%%%%%% %%% %%% % % % %
%.            % .  .  % % ..%     %.%
% % %%%%%.%.%%% % % %%%.% %%%.%%% % %
% % %     %.% % % %.   .%  .% % % % %
% %.%.%%%%%%% % %%%%%%%%% %%% %.%%% %
% % % %  .  %   %  .  %   ..%   %. .%
%%%.%%% % %%%%% %%%%% %%% %%% %%%%% %
%     % % %..   % %     %.%. .%.% % %
% % % % % %%% %%%.%%% %%% % %.% % % %
% % %.% %   .     ..  .   % %.%    .%
%%% %%%%%%% % % %%%%%.%%% % %%%.%%%%%
%       % % % %   . %  .% ... % %   %
%%%%%.% % %%%%%%%%% %%%%%%%%%%% %.%%%
%   % %.          % %     %.. % % . %
% %%% %%%%%.%%%%%%%%% %%%%% % %.%%% %
% %  .%      %      . %  .. %       %
% % % %%%%% %%% % % % %.%%%%%%%%%%%%%
%.% %  .%  .. % % % %..   . %  .% %.%
% % %%% %%% % % % %%%%%%%%% %%% % %.%
%.%.  % %.. % % %   % %  .% % %     %
% %%% %%% %%%%% %%% % % %%%%% % %%%%%
%     . %.  %   . % %    .%   % %   %
%%% %.%%%%% %%%%% %%% %%% % %%% %.%%%
% % % % % % % %   ..% %   % %   % % %
% %.%%% % % %.% %%%%%%%%% % %.% % % %
%   %   % . %    .         .  %     %
% % % % %%% %%% %%%%%%%.%%%.%%% %%% %
%P%P% %  ..  .%  .%    .  %   % %PP %
%%%%%%%%%%%%%%%%%%%%%%%%%%%%%%%%%%%%%