%%%%%%%%%%%%%%%%%%%%%%%%%%%%%%%%%%%%%
%...  . %     .   ..   .     ...  %.%
%..     . %%%%% % %%%.%%% %%%%%%% % %
%. .    % . ... %.%.    %     % %  .%
%%%%% %%%%%.%%%.% % % %%% %%%%% % %%%
%  .% % % %  .% % %.%   %.%..   %  .%
%.%%% % %.%.%%% %%%%% %%%.%.%%%.%%% %
%       %    .%   %.  %   . % % %  .%
%%% %%%%%%%%%.%%%%%%%.%%% %%% %.% % %
% .     ...   %.   .. %.%   %     % %
% %.%%%%% %.%%% % %.%%% % %%% %%% %.%
% % %     % % % %.%     %   % %.% %.%
% % %.%%%%%%% % %%%%%%%%% %%% % %%% %
%.% %.%   ..%. .%  .. % .   %   %.  %
%%% %%% % %%%%% %%%%% %%%.%%% %%%%% %
%    .%.%..       .   . % %.  % % % %
% % % % % .%  %%% %%% %%% % % % %.%.%
% % % % % %%    % %   %.  % % %. ...%
% % %%%%%  %  %%% %%% %.%%% %%% %%%%%
%. .  . %. % .  %.%  .%   ..  %.%   %
%.%%% %.% .%  %%% %%%.%%%%%%%%% % %%%
% . % %  . .   .   .  .   %   % %   %
% %%%.%%%%%%%%%%%%%%%%%%%%% % % %%%.%
% %  ...     .  .. .  ...   %   .   %
%.% % %%%%% %%%.% %.% % %%%%%%%%%%%%%
% % % . %    .% % % %..   . %   % %.%
% % %%%.%%% % % % %%%%%%%%%.%%%.% %.%
% % ..% %   % % %P .%.% . % % %. .  %
%.%%% %%% %%%.% %%%.% %.%%%%% % %%%%%
%... . .%   %. . .% .  .  %. .%.% ..%
%%% %.%%%%% %%%%% %%% %%% % %%% % %%%
% % % %.% %.% %. .  %.%.  %.%...% % %
%.%.%%% %.% %.% %%%%%%%%% %.% % % % %
%.  .P .%...   .       .      %   ..%
%.%.  % %%%.%%%.%%%%%%% %%% %%%.%%% %
%.%   % .    .% .   .    .%..   %  .%
%%%%%%%%%%%%%%%%%%%%%%%%%%%%%%%%%%%%%