%%%%%%%%%%%%%%%%%%%%%%%%%%%%%%%%%%%%%
%                                  P%
%            %                      %
%            %                      %
%            %                      %
%            %                      %
%            %                      %
%            %      %               %
%            %      %               %
%            %      %               %
%            %      %               %
%            %      %               %
%            %      %               %
%            %      %               %
%%%%%%%%%%%%%%      %%%%%%%%%%%%%%%%%
% PPPP       %                      %
%            %                      %
%            %                      %
%                                   %
%                                   %
%                                   %
%.       .                          %
%%%%%%%%%%%%%%%%%%%%%%%%%%%%%%%%%%%%%
