%%%%%%%%%%%%%%%%%%%%%%%%%%%%%%%%%%%%
%PP                       .      PP%
% %%%%%%%%%%%%%%%%%%% %%% %%%%%%%% %
%.%%  .%   %   .  %%% %%%   %% ... %
% %% % % % % %%%% %%%%%%%%% %% %%%%%
% %% %.% % % % .  %%     %%.%% ... %
% %% % % %.% % %%%%  %%% . .%%%%%%.%
% %  % % %   %   .%% %%%%%%%%  ... %
% %%.% % %%%%%%%% %%       .%% %%%%%
% %% %   %%       %%%%%%%%% %% ... %
%  . %%%%%%.%%%%%%%      %% %%%%%%.%
%%%%%%      %       %%%% %%.%  ... %
%     .%%%%%%.%%%%% %    %% %% %%%%%
% %%%%%%.   . % .    .%%%%% %%     %
%.       %%%%%% %%%%%%%%%%% %% .%% %
%%%%%%%%%%       ...   .   .%%%%%% %
%..        %%%%%%%%%%%%%%%% ...... %
%%%%%%%%%%%%%%%%%%%%%%%%%%%%%%%%%%%%