%%%%%%%%%%%%%%%%%%%%%%%%%%%%%%
%..     % % %  . .   . .   %.%
%.      % %.%%%%%% %%%%%%% % %
%  . . .% .   . .%     % %.  %
%%%%% %%%%% %%% %% %%%%% % %%%
%   % % % %   %    %     %.  %
% %%% %.%.% %%%%%%%% %%% %%% %
%P .    %. .. %%     % %.%   %
%%% % %%%%%%% %%%% %%% % % % %
%.% .    .    %% .   %  .  % %
% % %%%%% %.%%%% % %%% %%% %.%
% . %     % .    % %   % %%% %
%.  %P%%%%%     .%.%%%.%    .%
%%%%%%%%%%%%%%%%%%%%%%%%%%%%%%