%%%%%%%%%%%%%%%%%%%%%%%%%%%%
%     ..     %%      P     %
% %%%% %%%%% %% %%%%% %%%% %
%o%%%% %%%%% %% %%%%% %%%%o%
% %%%% %%%%% %% %%%%% %%%% %
%      .    .....          %
% %%%% %% %%%%%%%% %% %%%% %
% %%%% %% %%%%%%%% %% %%%% %
% ...  %%    %%    %%      %
%%%%%% %%%%% %% %%%%% %%%%%%
%%%%%% %%%%% %% %%%%% %%%%%%
%%%%%% %   .    .   % %%%%%%
%%%%%% % %%%%  %%%% % %%%%%%
%   ..   %  ...   %        %
%%%%%% % %%%%%%%%%% % %%%%%%
%%%%%% %  .  ....   % %%%%%%
%%%%%% % %%%%%%%%%% % %%%%%%
%    .....   %%            %
% %%%% %%%%% %% %%%%%.%%%% %
% %%%% %%%%% %% %%%%%.%%%% %
%   %%    ....        %%   %
%%% %% %% %%%%%%%% %% %%.%%%
%%% %% %% %%%%%%%% %% %%.%%%
%      %%    %%    %%  ..  %
% %%%%%%%%%% %% %%%%%%%%%% %
%  P      .   P  .   P  .  %
%%%%%%%%%%%%%%%%%%%%%%%%%%%%
