%%%%%%%%%%%%%%%%%%%%%%%%%%%%%%%%%%%%%
% .    .  .   .               .    P%
%   . .  .   %  . .      .   .     .%
%  . .     ..%.             ..     .%
%         .  %  .   .               %
%.        .. %  .     ..      .    .%
% .  .. .    %        ..  .     . ..%
% .        . %.   . %.  . .       . %
%   .        % .    %       .       %
%        .   %.     %...  .  .    ..%
%           .%.     %             . %
% .      .   %  . . %   .   .  .    %
%..  ...     %   .  % .  ..     .   %
%   .   .    %      % . .    .   . .%
%%%%%%%%%%%%%%.     %%%%%%%%%%%%%%%%%
% PPPP .  . .%   . .   .   .. .   . %
%         .  %.      . .            %
%       .   .%  .  .   .        .   %
% .    .        .      .. .    ...  %
%. .    .     .  .    .             %
%                .      . .       . %
%. .. .                         . ..%
%%%%%%%%%%%%%%%%%%%%%%%%%%%%%%%%%%%%%