%%%%%%%%%%%%%%%%%%%%%%%%%%%%%%%%%%%%%%
%            .  .               .   P%
% %%%%%%%%%%%%%%%%%%%.%%% .%%%%%%%%  %
% %%. .% . % . . .%%% %%%    %%      %
% %% % % % % %%%% %%%%%%%%%  %%  %%%%%
% %% % %.%.% %   .%%    .    %%      %
% %% % % %.% % %%%%%  %%%.   %%%%%%. %
% %%.% %.%   %    %%  %%%%%%%%%      %
% %% % % %%%%%%%% %% . .   ..%%  %%%%%
%.%%.%   %%   .   %%%%%%%%%  %%.     %
%    %%% %%.%%%%%%%      %%. %%%%%% .%
%%%%%%  .   %   ..  %   .%% .%%    . %
%   . .%%%%%% %%.  %%... %%  %%  %%%%%
% %%%%%%  . . %    .  %%%%% .%%.     %
%   ..     %%%%..   . %%%%%  %%%%%%  %
%%%%%%%%.  %   .   .   .     %%%%%%  %
%.      . .%%%%%%%%%%%%%%%%..    PPP %
%%%%%%%%%%%%%%%%%%%%%%%%%%%%%%%%%%%%%%
