%%%%%%%%%%%%%%%%%%%%%%%%%%%%%%%%%%%%%
%       % % %.          %   %    .%.%
% %%%%%%%.% %%% % %%% %%% %%%%%%% % %
%       %       % % .  .%  .  % %   %
%%%%%.%%%%% %%% % % % %%% %%%%% % %%%
%   % % % %   % % % %   % %   % %.  %
% %%% % % % %%% %%%%%.%%% % %%% %%% %
%       % . . % . %   %     % % %   %
%%% %%%%%%%%% %%%%%%% %%% %%% % % % %
%            .%       % %   %     % %
% %.%%%%% % %%% % %.%%% % %%% %%% % %
% % %  .. % % % % %     %   % %.% % %
% % %.%%%%%%% % %%%%%%%%% %%% % %%% %
% %.% %     %   %     %     %.  %   %
%%% %%% % %%%%% %%%%% %%% %%% %%%%% %
% .   %.% %     % %   . % %   % % % %
% %.% % % %%% %%% %%% %%%.% % % % % %
% % % % %     .    .   .  % % % . . %
%%% %%%%%%% % % %%%%% %%% % %%% %%%%%
%       % % % %  .. %   %  ...% %   %
%%%%% % % %%%%%%%%% %%%%%%%%%%% %.%%%
%   % %         . % %     %   % %   %
% %%% %%%%% %%%%%%%%% %%%%% %.% %%% %
% %   %      %   .    %     %       %
% % % %%%%% %%% % % % % %%%%%%%%%%%%%
% %.%   %  .  % % % %     . % . % % %
% % %%% %%% % % %.%%%%%%%%% %%% % % %
% %  .% %   % % %   % %   % % %  .  %
% %%% %%% %%%%% %%% % % %%%%% % %%%%%
% .     %   %     % %     %   % %   %
%%% %.%%%%% %%%%% %%% %%%.% %%% % %%%
% % %.% % % %.% . . %.%.  % %   % % %
% % %%% % % % % %%%%%%%%% % % % % % %
%   %   %   %     .       .  .%  . .%
% % % % %%% %%% %%%%%%%.%%% %%% %%%.%
%P%P% %       %   %       %   % %PP %
%%%%%%%%%%%%%%%%%%%%%%%%%%%%%%%%%%%%%