%%%%%%%%%%%%%%%%%%%%%%%%%%%%%%%%%%%%
%PP                              PP%
% %%%%%%%%%%%%%%%%%%% %%% %%%%%%%% %
% %%   %   %      %%% %%%   %% ... %
% %% % % % % %%%% %%%%%%%%% %% %%%%%
% %% % % % % %    %%     %% %% ... %
% %% % % % % % %%%%  %%%    %%%%%% %
% %  % % %   %    %% %%%%%%%%  ... %
% %% % % %%%%%%%% %%        %% %%%%%
% %% %   %%       %%%%%%%%% %% ... %
%    %%%%%% %%%%%%%      %% %%%%%% %
%%%%%%      %       %%%% %% %  ... %
%      %%%%%% %%%%% %    %% %% %%%%%
% %%%%%%      %       %%%%% %%     %
%        %%%%%% %%%%%%%%%%% %%  %% %
%%%%%%%%%%                  %%%%%% %
%.         %%%%%%%%%%%%%%%% ...... %
%%%%%%%%%%%%%%%%%%%%%%%%%%%%%%%%%%%%