%%%%%%%%%%%%%%%%%%%%%%%%%%%%%%%%%%%%%
%.  .   %  ...                PPPP%.%
%         %%%%%.% %%% %%% %%%%%%% % %
%  . .  %       % %     %     % %   %
%%%%% %%%%% %%% % % % %%% %%%%% % %%%
%   % % %.%. .% % % %   % %   . %   %
% %%% % %.% %%% %%%%% %%% % %%% %%% %
% .     %  . .% . %   % . . % % %  .%
%%% %%%%%%%%% %%%%%%% %%% %%% % % % %
%      .      %.  .   %.%   %     % %
% % %%%%% % %%% % % %%% % %%%.%%% % %
% % %  .  % % % % %   . %   % % % % %
% % %.%%%%%%% % %%%%%%%%% %%%.% %%% %
% % % % .   %   %.    %   . %   %   %
%%% %%% % %%%%% %%%%%.%%% %%% %%%%% %
%     % %   .     .     %.%   % % % %
% % % % %  %  %%%.%%% %%% % % % % % %
%.% % % % %%    % %   %   % % %.. . %
% % %%%%%  %  %%% %%% % %%% %%% %%%%%
%     . %  %    % %  .%       % %.. %
% %%% % %  %. %%% %%% %%%%%%%%% % %%%
%   % %                  .%   % %   %
% %%% %%%%%%%%%%%%%%%%%%%%% % % %%% %
% %                  .      %       %
% % % %%%%% %%% % % % % %%%%%%%%%%%%%
% % %   % ..  % % % %       %   % % %
% % %%% %%% % % % %%%%%%%%% %%% % % %
% %   % %.  % % %P  % %   %.%.%  .  %
% %%% %%% %%% % %%% % % %%%%% % %%%%%
%       %   %     %       %   % %   %
%%% % %%%%% %%%%% %%% %%% % %%% % %%%
% % % % % % % %     % %   % %. .% % %
% % %%% % % % % %%%%%%%%% % % %.% % %
% .     %      .  .           %    .%
% %   % %%% %%%.%%%%%%%.%%% %%% %%% %
%.%   %     . %           %     %  .%
%%%%%%%%%%%%%%%%%%%%%%%%%%%%%%%%%%%%%