%%%%%%%%%%%%%%%%%%%%%%%%%%%%%%%%%%%%%
% .   . % % %           % . %     % %
% %%%%%%%.% %%% % %%% %%% %%%%%%% % %
%      .%     . % %     %     % %   %
%%%%% %%%%% %%% % % % %%% %%%%% % %%%
%   % %.% %   % % % %   % %  .% %.  %
% %%% % %.% %%% %%%%% %%% % %%% %%% %
%       %     %   %   %.    % % %   %
%%% %%%%%%%%%.%%%%%%% %%% %%%.% % % %
%             %  .    % %   % .   % %
% % %%%%% % %%%.% % %%% % %%% %%% % %
% % %   . % %.% % %     %  .% % % % %
% % % %%%%%%% % %%%%%%%%% %%% % %%% %
% % % %     %  .%..  .%     %   %   %
%%% %%% % %%%%% %%%%% %%% %%% %%%%% %
%     % % %     % %     %.%   %.% % %
% % % % % %%%.%%% %%% %%% % % % % % %
% % % % %                 % % %  .  %
%%% %%%%%%%.% % %%%%% %%% % %%% %%%%%
% . .   % % % %    .%   % .   %.%   %
%%%%% % % %%%%%%%%% %%%%%%%%%%% % %%%
%   % %           % %     %. .% % . %
%.%%% %%%%% %%%%%%%%%.%%%%% % % %%% %
% %.. %.     %        %.   .%       %
% % % %%%%% %%% % % % %.%%%%%%%%%%%%%
% % %  .%     % % % %    .  %  .% % %
% %.%%% %%% % % % %%%%%%%%% %%% % % %
% %   % %   %.% % . % %  .% % %  .  %
% %%% %%% %%%%% %%% % % %%%%% %.%%%%%
%       %   %     % %     %   % %  .%
%%% % %%%%% %%%%% %%% %%% %.%%% % %%%
% % % % % %.% %     % %   % %   % % %
% % %%% % % % % %%%%%%%%% % % % % % %
%   %   %   %     .           %     %
% % % % %%% %%% %%%%%%%.%%%.%%% %%% %
%P%P% %     . % . %     ..%   % %PP.%
%%%%%%%%%%%%%%%%%%%%%%%%%%%%%%%%%%%%%