%%%%%%%%%%%%%%%%%%%%%%%%%%%%%%%%%%%%%%
%      .                            P%
% %%%%%%%%%%%%%%%%%%% %%%  %%%%%%%%  %
% %%   %   %      %%% %%%    %%      %
% %% % % % % %%%% %%%%%%%%%  %%  %%%%%
% %% % % % % %    %%         %%      %
% %% % % % % % %%%%%  %%%    %%%%%%  %
% %% % % %   %    %%  %%%%%%%%%      %
% %% % % %%%%%%%% %%         %%  %%%%%
% %% %   %%       %%%%%%%%%  %%      %
%    %%% %% %%%%%%%      %%  %%%%%%  %
%%%%%%  .   %    .  %    %%  %%      %
%      %%%%%% %%   %%    %%  %%  %%%%%
% %%%%%%      %       %%%%%  %%      %
%          %%%%       %%%%%  %%%%%%  %
%%%%%%%%   %     .           %%%%%%  %
%.         %%%%%%%%%%%%%%%%      PPP %
%%%%%%%%%%%%%%%%%%%%%%%%%%%%%%%%%%%%%%
