%%%%%%%%%%%%%%%%%%%%%%%%%%%%%%%
%   . %                 %     %
% %%% % %%% %%%%%%% %%%.% . . %
% %   % %      % ..  .% %     %
%   %%% % %%%% % %%%%   %%%   %
%%% % % % %     .%  % % . % %%%
%   % %%% % %%% %%%.% %%%.%   %
% %%%   .   % .   %       %%% %
%   % %%%%% %%%%%%% % %%% % . %
%%% %   %.%    %.   % %   %.%%%
%   %%% % %%%% % %%%% % %%%   %
%     ..%      %      %     %.%
%   . % %%% %%%%%%% %%% % %%% %
%PP . %  P     P    %   %     %
%%%%%%%%%%%%%%%%%%%%%%%%%%%%%%%