%%%%%%%%%%%%%%%%%%%%%%%%%%%%%%%%%%%%%
%.                      .          P%
%   .       .%    .    .  .         %
%.   . .     %                      %
%            %                      %
%            %           .  .       %
%.  .        %         .     .   .  %
%            %   .  %               %
%         .  %      %..     .       %
%. .         % .   .%               %
%    .    .. % .    %.            ..%
% .   . .    %      %        .     .%
%     .   .  %      %..             %
%            %      % .         ..  %
%%%%%%%%%%%%%% . .  %%%%%%%%%%%%%%%%%
%.PPPP       %     .                %
%.           %  .                   %
%          . %                    . %
%    .                           .  %
%            . .  .    .          . %
%          .          .     .  ..   %
%.                        .      .  %
%%%%%%%%%%%%%%%%%%%%%%%%%%%%%%%%%%%%%