%%%%%%%%%%%%%%%%%%%%%%%%%%%%%%%%%%%%%
%.   . .%  . .   .              ..%.%
%         %%%%%.% %%% %%%.%%%%%%% % %
%     . % .     % %     %     % %   %
%%%%%.%%%%% %%% % % % %%% %%%%% % %%%
%.  %.% % %   % % % % . % % ..  %   %
% %%%.% %.% %%% %%%%% %%%.% %%% %%% %
%  . .. %.    %  .% . %. .. % %.%.  %
%%%.%%%%%%%%% %%%%%%% %%% %%%.% % % %
%     .       % . .   % %   %.    % %
% % %%%%% % %%% % % %%%.% %%% %%% % %
%.% % .   % % % % %     %   % % % % %
%.%.% %%%%%%% %.%%%%%%%%% %%% % %%% %
%.%.%.%..   %   %.    %     %   %   %
%%% %%% %.%%%%% %%%%% %%% %%% %%%%% %
% ....%.%   .      .    % % . %.% % %
% % % % %  % .%%% %%%.%%%.% %.% % %.%
% % % % % %%    % %   %  .%.% %. .  %
% %.%%%%%  %. %%%.%%% % %%% %%% %%%%%
%.      %  %.  .% %   %       %.%  .%
%.%%% % %  % .%%% %%% %%%%%%%%% % %%%
%   % %.   .      . ...   %   % %.  %
% %%% %%%%%%%%%%%%%%%%%%%%% % % %%% %
%.%      .    ...           %       %
% %.% %%%%% %%% % % % % %%%%%%%%%%%%%
% % %.  % .  .%.% % %       %.  % % %
%.% %%% %%% % % % %%%%%%%%% %%% % % %
% %   % %   % % %P  %.%   % % %     %
% %%% %%% %%% %.%%% % % %%%%% % %%%%%
%       %   %.    %  ..   %   % %   %
%%% % %%%%% %%%%% %%%.%%% % %%%.% %%%
% % % %.% %.% % .. .% % . %.%   % %.%
% % %%% % %.% % %%%%%%%%%.% % %.%.% %
%...   .%    .     .        . %     %
% %   %.%%%.%%% %%%%%%% %%% %%% %%% %
%.%  .%      .%   . .     %  . .%  .%
%%%%%%%%%%%%%%%%%%%%%%%%%%%%%%%%%%%%%