%%%%%%%%%%%%%%%%%%%%%%%%%%%%%%%%%%%%%
%  .  . %.% %  ..       %   %   . % %
% %%%%%%% % %%% % %%% %%%.%%%%%%% %.%
%   ... % ...   % %.. . %.  . % %  .%
%%%%% %%%%% %%% % % % %%%.%%%%% %.%%%
%   %.%.% %.  %.% %.% . % %. .% %.  %
%.%%%.% % %.%%% %%%%% %%%.% %%% %%% %
%    .. %    .%.  %.  % .   % %.%  .%
%%% %%%%%%%%% %%%%%%% %%% %%% % % % %
%     .   .   %       % %  .%  .. %.%
% %.%%%%% % %%%.% % %%% % %%% %%% % %
% %.%.    % % %.% %  .. %   % % % % %
% %.% %%%%%%% % %%%%%%%%% %%% %.%%% %
%.%.%.%..   %  .%.  ..% .. .%. .%   %
%%% %%% % %%%%% %%%%%.%%% %%% %%%%% %
%  .. % % %     %.%..  .%.%   % %.% %
% % %.%.%.%%% %%% %%%.%%%.% % % % %.%
% %.% % %..   .  . .    . %.% % ..  %
%%%.%%%%%%% % % %%%%%.%%%.%.%%%.%%%%%
%..     %.% % %.    %  .%.   .% %. .%
%%%%% % % %%%%%%%%% %%%%%%%%%%% % %%%
%.  % %   . .  .  %.%   . %   %.%  .%
% %%%.%%%%% %%%%%%%%% %%%%% %.% %%% %
%.%   %    . % .     .%  ...%    .  %
%.% %.%%%%% %%% %.%.% % %%%%%%%%%%%%%
% %.%   %.    % %.% % .     %. .% %.%
% %.%%% %%% % %.% %%%%%%%%%.%%% % % %
%.%   %.%   % % %   %.% . % % %     %
%.%%% %%% %%%%% %%% % % %%%%% % %%%%%
%.    . %. .% . . %.% .. .%.  % %.  %
%%% % %%%%% %%%%% %%% %%%.%.%%% % %%%
% %.%.% % % % % ..  % % ..% %   %.%.%
% %.%%% % % % % %%%%%%%%%.% % % % % %
%.  %   % . %  ..       .     %  .. %
% % %.% %%%.%%%.%%%%%%% %%%.%%% %%%P%
%.% % %. . .. % ..%       %.  %.%PPP%
%%%%%%%%%%%%%%%%%%%%%%%%%%%%%%%%%%%%%