%%%%%%%%%%%%%%%%%%%%%%%%%%%%%%%%%%%%%
%       % % %     .   . %   %     % %
% %%%%%%% % %%% %.%%% %%%.%%%%%%% % %
%  . .  %       % %     %    .% %   %
%%%%% %%%%%.%%% % % % %%% %%%%% % %%%
%  .%.% %.%   % % % %  .% %   % %   %
%.%%% % % % %%% %%%%% %%% % %%% %%% %
%  .    %.    %   %   %     % % %   %
%%% %%%%%%%%% %%%%%%% %%% %%% % % % %
%       . .   %  .    % %   %     % %
% % %%%%% % %%%.% % %%% % %%% %%% % %
% % %     % % % % %    .%   % %.% % %
% %.%.%%%%%%% % %%%%%%%%%.%%% % %%% %
% % % %     %   %     %     %   %.  %
%%%.%%% % %%%%% %%%%% %%% %%% %%%%% %
%     % %.%    .% %     % %   % % % %
% % % % %.%%% %%% %%% %%% % % % % % %
% % % % %.  .          .. % % % .   %
%%% %%%%%%% % % %%%%%.%%% % %%% %%%%%
%   .   % % % %     %   %     % %   %
%%%%% %.% %%%%%%%%% %%%%%%%%%%% % %%%
%   %.%     ..    % %.    %   % %   %
% %%% %%%%% %%%%%%%%% %%%%% % % %%% %
% %   %      % .      %     %       %
%.%.%.%%%%%.%%% % % % % %%%%%%%%%%%%%
%.% %   %    .%.% % %       %   % % %
% % %%%.%%% %.% % %%%%%%%%% %%% % % %
% %   % %   % % %   %.%   % % %    .%
% %%% %%% %%%%% %%% % % %%%%% % %%%%%
%       %   %     % %     %   % % . %
%%% % %%%%% %%%%% %%% %%% % %%% % %%%
% % % % % % % %.    % %   % % . % % %
% %.%%% % % % % %%%%%%%%% % % % % % %
%   %   %. .%        .   .   .%     %
% % % % %%% %%% %%%%%%% %%% %%% %%%P%
%.% % %  .    %   %       %   % %PPP%
%%%%%%%%%%%%%%%%%%%%%%%%%%%%%%%%%%%%%