%%%%%%%%%%%%%%%%%%%%%%%%%%%%%%%%%%%%%
%.  .   %          .     .        %.%
%     .   %%%%% % %%% %%% %%%%%%% % %
%..     %      .% %     %     % %.  %
%%%%% %%%%% %%% % % % %%% %%%%% % %%%
%.  % % % %  .%.% % % . % %     %   %
% %%% % % % %%% %%%%% %%% % %%% %%% %
%. .    %     %   %.  %     % % %   %
%%% %%%%%%%%% %%%%%%% %%% %%% % % % %
%    .        %       % %   %     % %
% % %%%%% % %%%.% % %%%.% %%% %%% % %
% % %     % % % % % .   %   % % % % %
% % % %%%%%%%.% %%%%%%%%% %%% % %%% %
% % %.% .   %   %     %     %  .%   %
%%% %%% % %%%%% %%%%% %%% %%%.%%%%% %
%    .% %       .       % %   % %.% %
% % % % %  % .%%% %%% %%% % % % % % %
% % % % % %%  . % %   %   % % %.    %
% % %%%%%  %  %%% %%% % %%% %%%.%%%%%
%   .   %  %   .% %  .%   .   % %   %
%P%%% % %  %  %%% %%% %%%%%%%%% % %%%
%   % % .   .             %.  % %   %
% %%% %%%%%%%%%%%%%%%%%%%%% % % %%% %
% %                    .    %       %
% % % %%%%% %%% % % % % %%%%%%%%%%%%%
% % %.  %     % %.% %     . %   % %.%
% % %%% %%% % %.% %%%%%%%%% %%%.%.% %
%.%   % %   % % %P  % %   % % %     %
% %%% %%% %%%.% %%% % % %%%%% % %%%%%
%       %   %     %  .    %   %.%   %
%%% % %%%%% %%%%% %%% %%% % %%% % %%%
% %.% % %.% % %    .% %   % %   % % %
% % %%% % %.% % %%%%%%%%%.% %.% % % %
%       %    .       .        %.    %
% %   % %%%.%%% %%%%%%% %%% %%% %%%.%
%.%   %  .    %           %     %. .%
%%%%%%%%%%%%%%%%%%%%%%%%%%%%%%%%%%%%%