%%%%%%%%%%%%%%%%%%%%%%%%%%%%%%%%%%%%%
%       % % % .     .   %   %  .  % %
%.%%%%%%% % %%% % %%% %%% %%%%%%% % %
% .     %       % %     % .   % %   %
%%%%% %%%%% %%% % % % %%% %%%%% % %%%
% . % % % %   % % % %   % %   % %   %
% %%% % % % %%% %%%%%.%%% % %%% %%% %
%       %..   % . %   %     %.% % . %
%%%.%%%%%%%%% %%%%%%% %%% %%% % % % %
%   .     .   %    .  % % . %     % %
% % %%%%%.% %%% % % %%% % %%% %%% %.%
% % %     % % % % %     %   % % % % %
% % % %%%%%%% %.%%%%%%%%% %%% % %%% %
% % % % .   %   %   . %.    % . %   %
%%%.%%% % %%%%%.%%%%%.%%% %%% %%%%% %
%     %.% %     % %     % %  .% % % %
% % % % % %%%.%%% %%% %%% % % % % % %
% % % % %   . .    .     .%.%.%     %
%%% %%%%%%% %.% %%%%% %%% % %%% %%%%%
%.      % % % %     %   %     % %   %
%%%%% % % %%%%%%%%% %%%%%%%%%%%.% %%%
%   % %  ..       % %  .  %   % %   %
% %%% %%%%% %%%%%%%%% %%%%% % % %%% %
% %   %      %        %     %       %
% % % %%%%% %%% % % % % %%%%%%%%%%%%%
% %.%.  %    .% % % %   ..  %   % % %
% % %%% %%% % % % %%%%%%%%%.%%% % %.%
% %   % %   % % %   % %   % %.%     %
% %%% %%% %%%%% %%% % % %%%%% % %%%%%
%       %   %     %.%     %   % %.  %
%%% % %%%%% %%%%% %%% %%% % %%% % %%%
% % % % % % % %     % % . % %  .%.% %
% % %%% % % % % %%%%%%%%% % % % % % %
%   %   %   %              ...%   . %
% % % % %%% %%% %%%%%%% %%% %%% %%%P%
%.% % %    .  %  .%       % . % %PPP%
%%%%%%%%%%%%%%%%%%%%%%%%%%%%%%%%%%%%%