%%%%%%%%%%%%%%%%%%%%%%%%%%%%%%%%%%%%%
%   .  .% % % .         %  .%    .%.%
% %%%%%%% % %%% % %%%.%%% %%%%%%% % %
%      .%   . . %.% .   %     % %  .%
%%%%%.%%%%% %%% % % % %%%.%%%%% % %%%
%  .%.% %.%   % % % %.. % %   % % . %
% %%%.%.% %.%%% %%%%% %%% % %%% %%% %
%.. . . % .   %   % . %   . % % %   %
%%% %%%%%%%%% %%%%%%% %%% %%% % %.% %
%   .        .%       % % . %   . %.%
%.% %%%%% % %%% %.% %%% % %%%.%%%.% %
% % %     % % %.% %     %   % % % %.%
% %.%.%%%%%%% % %%%%%%%%% %%% % %%% %
% % % %    .%   %     %     % . % . %
%%% %%%.% %%%%% %%%%% %%% %%% %%%%% %
%.    % % % ..  %.%  .  % %   %.% % %
% %.% %.% %%%.%%% %%%.%%% % % % % % %
% % % %.% .  .            % % %  .  %
%%% %%%%%%% %.% %%%%% %%% % %%%.%%%%%
%       % % % % . . %  .%     %.%   %
%%%%% %.% %%%%%%%%% %%%%%%%%%%% % %%%
% . % %           % %  .  %   % %  .%
%.%%%.%%%%% %%%%%%%%% %%%%%.% % %%% %
% % ..%  ..  %.       %     %  .    %
% % % %%%%%.%%% % % % %.%%%%%%%%%%%%%
% % % . %     %.%.% %.   ...% . % % %
% % %%%.%%% %.% % %%%%%%%%%.%%% % % %
% %   % %   %.% %   % %.. % % %    .%
% %%% %%% %%%%% %%% % % %%%%% % %%%%%
%  .    % . % ... % %     %   %.%. .%
%%% % %%%%% %%%%% %%% %%% %.%%% % %%%
% % % % % % %.%     % %   % %   % % %
%.% %%% % % % %.%%%%%%%%% %.% %.% % %
%   %   %   %.  .    .   ..  .%     %
% %.% % %%% %%% %%%%%%% %%% %%% %%%P%
%.% % %.      %  .%.    . %...% %PPP%
%%%%%%%%%%%%%%%%%%%%%%%%%%%%%%%%%%%%%