%%%%%%%%%%%%%%%%%%%%%%%%%%%%%%%%%%%%%
%     . %.% %   ...   . %   %     %.%
% %%%%%%% % %%% %.%%% %%% %%%%%%% % %
%. .    %  . . .% %. .  %   ..% %  .%
%%%%% %%%%% %%% % % % %%% %%%%%.% %%%
%   % %.%.%   % %.% %   % %.. % %   %
% %%% % % % %%% %%%%% %%% % %%% %%% %
%.. .   % .   %.  %  .% ..  %.% %  .%
%%% %%%%%%%%% %%%%%%%.%%% %%% %.% % %
%      .   .. %     . % %.  %.    % %
%.% %%%%% % %%%.% %.%%% % %%% %%% % %
% % % .   % %.%.% %     %   %.% % %.%
%.% % %%%%%%% %.%%%%%%%%% %%%.% %%% %
% % % % .   % . %     %     % . %   %
%%% %%%.% %%%%% %%%%% %%% %%% %%%%% %
%.    % % % .. .%.%  . .% % . % % % %
% % % % % %%% %%% %%% %%% % % % %.% %
% %.% % %   ..     .   .  % % %     %
%%%.%%%%%%% % % %%%%% %%% % %%% %%%%%
%..   . %.% %.%.   .%   %  .  % %   %
%%%%% % % %%%%%%%%% %%%%%%%%%%%.% %%%
%.  %.% .   .     % % .   %   % % . %
%.%%% %%%%% %%%%%%%%% %%%%%.% % %%% %
% %   %      %       .% .   %.    . %
% % %.%%%%% %%% % %.% % %%%%%%%%%%%%%
% % %. .%     % % % %  .    %   % % %
% % %%% %%% % % % %%%%%%%%% %%% % %.%
%.%   % %.  % % %   % %   % % %     %
% %%% %%% %%%%% %%% % % %%%%% %.%%%%%
%       %   % .   % %.  . % . %.%.  %
%%% % %%%%% %%%%% %%% %%% % %%% %.%%%
% % % % % %.% %..  .% %   % % . % % %
% % %%% % %.%.% %%%%%%%%% % % % % % %
%   %.  %   %  .     .        % .  .%
% % % % %%% %%%.%%%%%%% %%% %%% %%%.%
%P%P% % . .   %   %..   . %   %.%PP %
%%%%%%%%%%%%%%%%%%%%%%%%%%%%%%%%%%%%%