%%%%%%%%%%%%%%%%%%%%%%%%%%%%%%%%%%%%%
%  ... .%.%.%    .      % ..%     % %
% %%%%%%%.% %%% % %%% %%% %%%%%%% % %
% .   . %      .%.%  . .%  . .% %.  %
%%%%%.%%%%%.%%% % % %.%%%.%%%%%.% %%%
%  .%.% %.%  .% %.%.%   % %   % % . %
% %%% % % % %%% %%%%%.%%% % %%% %%% %
%.      %.    % . %.  % ..  %.%.%...%
%%% %%%%%%%%% %%%%%%%.%%% %%% % % %.%
%.   . .      %. .... %.%  .%     %.%
% %.%%%%% % %%%.% %.%%%.% %%%.%%% % %
%.%.%. .  %.%.% % %.  ..%  .%.% % % %
% % %.%%%%%%%.% %%%%%%%%% %%%.%.%%% %
% % %.%.    %   %.    %   ..%.  %. .%
%%%.%%% %.%%%%% %%%%% %%% %%% %%%%% %
%..  .% % %  . .%.%..   % %.  % %.% %
% % % %.% %%% %%%.%%% %%%.% % % % % %
% % %.%.%   .    ...      % % %.   .%
%%%.%%%%%%% %.% %%%%% %%%.% %%% %%%%%
% ...   %.% %.%. .. % ..%.. . % %   %
%%%%% % % %%%%%%%%% %%%%%%%%%%% % %%%
%   % %. .   .    % %.. . %   % %   %
% %%% %%%%% %%%%%%%%%.%%%%% %.%.%%% %
% %   %      % .      %.   .%  ..  .%
%.% % %%%%% %%% %.% % % %%%%%%%%%%%%%
% % %   %.    % % %.% . .   %.. %.% %
%.%.%%% %%% % % % %%%%%%%%% %%% %.% %
% %.  % %   % % %. .%.%  .% %.% ... %
%.%%%.%%% %%%%% %%% % % %%%%% % %%%%%
%  .    % . %.   .% %     %   % %   %
%%% %.%%%%% %%%%% %%%.%%% % %%% % %%%
% % % % % %.% % . . % %  .% %   % % %
% % %%%.%.% % %.%%%%%%%%% % % % %.% %
%  .%   % . % ..   .    .  . .%.  . %
% % % % %%%.%%% %%%%%%% %%% %%% %%%P%
%.%.% %.      %.  % .   . %   %.%PPP%
%%%%%%%%%%%%%%%%%%%%%%%%%%%%%%%%%%%%%