%%%%%%%%%%%%%%%%%%%%%%%%%%%%
%    .       %%      .  .  %
% %%%% %%%%% %% %%%%% %%%% %
%o%%%% %%%%% %% %%%%% %%%%o%
% %%%% %%%%%.%% %%%%% %%%% %
% .    .  ..   .    .      %
% %%%%.%%.%%%%%%%% %% %%%% %
% %%%%.%% %%%%%%%% %% %%%% %
%      %%.   %%    %%    . %
%%%%%% %%%%% %% %%%%%P%%%%%%
%%%%%% %%%%% %% %%%%% %%%%%%
%%%%%% %        .   % %%%%%%
%%%%%% % %%%%. %%%% % %%%%%%
%        %  .     %.. . . .%
%%%%%% % %%%%%%%%%% % %%%%%%
%%%%%%.%     ...  ..% %%%%%%
%%%%%% %.%%%%%%%%%%.% %%%%%%
%     .  ..  %% .    .     %
% %%%%.%%%%% %% %%%%% %%%% %
% %%%%.%%%%% %%.%%%%% %%%% %
%...%%     ..  . . . .%%  .%
%%%.%% %% %%%%%%%% %%.%%.%%%
%%% %% %% %%%%%%%%.%% %% %%%
%      %% .  %%.   %%      %
% %%%%%%%%%% %%.%%%%%%%%%%.%
%             P        .   %
%%%%%%%%%%%%%%%%%%%%%%%%%%%%