%%%%%%%%%%%%%%%%%%%%%%%%%%%%%%%%%%%%%
%  .    % %.%   .     ..%   %.    % %
% %%%%%%% % %%% % %%% %%% %%%%%%% %.%
%     . %       % %. .  % .  .% %   %
%%%%% %%%%% %%% % % %.%%% %%%%%.%.%%%
%   % % % %   % % % %   % % . % %   %
%.%%% % % %.%%% %%%%% %%%.% %%% %%% %
%       %    .%   %  .%.    % % %  .%
%%% %%%%%%%%% %%%%%%% %%% %%% % % % %
%          . .%       % %.. %   . % %
%.% %%%%% %.%%% % %.%%%.% %%% %%% % %
% % %     % % % %.%.   .%  .% % % %.%
% % % %%%%%%%.%.%%%%%%%%% %%% % %%% %
% % %.%     %.  % .   % . . % ..%.  %
%%% %%% %.%%%%% %%%%% %%% %%% %%%%%.%
%. .. % % %   . % %  .  % %   % % %.%
% %.% % % %%% %%% %%% %%% % %.% % % %
% % % %.%          .     .%.% %.    %
%%% %%%%%%% % %.%%%%% %%% % %%% %%%%%
%.      % %.%.%     % . %   . % %  .%
%%%%% % % %%%%%%%%% %%%%%%%%%%% % %%%
% . % %  . .  .   % %     %   %.%  .%
% %%% %%%%% %%%%%%%%% %%%%% % % %%% %
% %   % .    %.   . . %    .%     . %
% % % %%%%% %%% % %.%.% %%%%%%%%%%%%%
% % %   %     % % % %       %   %.%.%
% % %%% %%% % % % %%%%%%%%% %%%.% % %
% %  .% %.. % %.%   % %   % % %     %
%.%%% %%%.%%%%% %%% %.% %%%%% % %%%%%
%       % . % ..  % %   ..% ..%.%   %
%%% % %%%%% %%%%% %%% %%% %.%%% % %%%
% % %.% % %.% % ..  % %. .% %  .%.%.%
%.%.%%% % % % % %%%%%%%%% % % % % %.%
%   % . %   % .  . .    .  .  %     %
% % % % %%%.%%%.%%%%%%% %%% %%% %%%P%
%.% % %   ... % . %       %  .%.%PPP%
%%%%%%%%%%%%%%%%%%%%%%%%%%%%%%%%%%%%%